"Kunden Nr."	"Kunde"	"Material Nr."	Anfangsbestand	Retourniert	Zu berechnen
"100001"	"BPW-Fahrzeugtechnik"	"12.999.01.001"	-6	0	-6
"100001"	"BPW-Fahrzeugtechnik"	"12.999.01.003"	26	0	26
"100001"	"BPW-Fahrzeugtechnik"	"12.999.01.008"	1	0	1
"100002"	"M. Busch GmbH & Co. KG"	"12.999.01.001"	7	10	-3
"100002"	"M. Busch GmbH & Co. KG"	"12.999.01.003"	-32	0	-32
"100002"	"M. Busch GmbH & Co. KG"	"12.999.01.008"	-21	8	-29
"100003"	"F. HESTERBERG & SOEHNE"	"12.999.01.001"	-1	18	-19
"100003"	"F. HESTERBERG & SOEHNE"	"12.999.01.003"	2	0	2
"100003"	"F. HESTERBERG & SOEHNE"	"12.999.01.008"	20	0	20
"100010"	"BPW ITALIA S.R.L."	"12.999.01.001"	263	14	249
"100010"	"BPW ITALIA S.R.L."	"12.999.01.003"	1	21	-20
"100010"	"BPW ITALIA S.R.L."	"12.999.01.008"	-174	0	-174
"100010"	"BPW ITALIA S.R.L."	"12.999.01.188"	354	23	331
"100012"	"BPW LIMITED"	"12.999.01.001"	3	315	-312
"100012"	"BPW LIMITED"	"12.999.01.003"	817	107	710
"100012"	"BPW LIMITED"	"12.999.01.008"	192	43	149
"100012"	"BPW LIMITED"	"12.999.01.162"	1	1516	-1515
"100012"	"BPW LIMITED"	"12.999.01.163"	377	162	215
"100012"	"BPW LIMITED"	"12.999.01.188"	2	66	-64
"100013"	"BPW ITALIA S.R.L."	"12.999.01.003"	49	0	49
"100014"	"BPW EJES ESPAÑA, S.A."	"12.999.01.188"	6	0	6
"100015"	"FOMA"	"12.999.01.001"	2	0	2
"100015"	"FOMA"	"12.999.01.003"	482	19	463
"100016"	"BPW KRAATZ OY"	"12.999.01.003"	822	31	791
"100016"	"BPW KRAATZ OY"	"12.999.01.008"	5	0	5
"100016"	"BPW KRAATZ OY"	"12.999.01.188"	56	0	56
"100018"	"TRANSPORT-TEKNIK A/S"	"12.999.01.003"	246	14	232
"100020"	"FAHRZEUGBEDARF AG"	"12.999.01.001"	1	0	1
"100020"	"FAHRZEUGBEDARF AG"	"12.999.01.003"	17	0	17
"100020"	"FAHRZEUGBEDARF AG"	"12.999.01.008"	5	0	5
"100021"	"BPW Hofstad A/S"	"12.999.01.003"	2	2	0
"100021"	"BPW Hofstad A/S"	"12.999.01.008"	2	2	0
"100023"	"BPW Polska Sp. z o.o."	"12.999.01.001"	0	0	0
"100023"	"BPW Polska Sp. z o.o."	"12.999.01.003"	13	0	13
"100023"	"BPW Polska Sp. z o.o."	"12.999.01.188"	12	0	12
"100024"	"BPW spol. s.r.o."	"12.999.01.001"	2	0	2
"100024"	"BPW spol. s.r.o."	"12.999.01.003"	2	0	2
"100025"	"BPW-HUNGARIA KFT."	"12.999.01.001"	3	808	-805
"100025"	"BPW-HUNGARIA KFT."	"12.999.01.003"	-302	550	-852
"100025"	"BPW-HUNGARIA KFT."	"12.999.01.008"	1	688	-687
"100025"	"BPW-HUNGARIA KFT."	"12.999.01.011"	7	0	7
"100025"	"BPW-HUNGARIA KFT."	"12.999.01.162"	2	450	-448
"100025"	"BPW-HUNGARIA KFT."	"12.999.01.163"	302	101	201
"100025"	"BPW-HUNGARIA KFT."	"12.999.01.188"	-44	402	-446
"100029"	"HBN-TEKNIK A/S"	"12.999.01.001"	3	0	3
"100030"	"BPW TRAPACO S.L."	"12.999.01.003"	45	0	45
"100030"	"BPW TRAPACO S.L."	"12.999.01.008"	35	0	35
"100030"	"BPW TRAPACO S.L."	"12.999.01.162"	32	0	32
"100030"	"BPW TRAPACO S.L."	"12.999.01.163"	9	0	9
"100030"	"BPW TRAPACO S.L."	"12.999.01.188"	21	0	21
"100032"	"BPW FRANCE SAS"	"12.999.01.001"	39	3	36
"100032"	"BPW FRANCE SAS"	"12.999.01.003"	443	8	435
"100032"	"BPW FRANCE SAS"	"12.999.01.008"	-11	0	-11
"100032"	"BPW FRANCE SAS"	"12.999.01.162"	-30	0	-30
"100032"	"BPW FRANCE SAS"	"12.999.01.163"	-5	0	-5
"100032"	"BPW FRANCE SAS"	"12.999.01.188"	428	0	428
"100035"	"BPW Benelux sprl."	"12.999.01.001"	872	171	701
"100035"	"BPW Benelux sprl."	"12.999.01.003"	-135	59	-194
"100035"	"BPW Benelux sprl."	"12.999.01.008"	156	20	136
"100035"	"BPW Benelux sprl."	"12.999.01.162"	745	52	693
"100035"	"BPW Benelux sprl."	"12.999.01.163"	158	15	143
"100035"	"BPW Benelux sprl."	"12.999.01.165"	4	0	4
"100035"	"BPW Benelux sprl."	"12.999.01.188"	94	120	-26
"100036"	"Busch - Hungaria Kft."	"12.999.01.001"	366	784	-418
"100036"	"Busch - Hungaria Kft."	"12.999.01.003"	-115	0	-115
"100042"	""XL PARTS" SIA"	"12.999.01.003"	1	0	1
"100043"	"Besko A/S"	"12.999.01.003"	142	4	138
"100048"	"Släpis AB"	"12.999.01.001"	8	0	8
"100048"	"Släpis AB"	"12.999.01.003"	127	10	117
"100049"	"Marpeto Polska Sp. z o.o."	"12.999.01.003"	0	0	0
"210118"	"ASCHWEGE & TOENJES GMBH"	"12.999.01.162"	6	0	6
"210118"	"ASCHWEGE & TOENJES GMBH"	"12.999.01.163"	2	0	2
"210234"	"LUDWIG BERGMANN GMBH"	"12.999.01.001"	1	0	1
"210235"	"BRIRI GMBH"	"12.999.01.003"	1	0	1
"210242"	"Bruns GmbH & Co. KG"	"12.999.01.001"	0	0	0
"210242"	"Bruns GmbH & Co. KG"	"12.999.01.003"	0	0	0
"210247"	"Blomenröhr Fahrzeugbau GmbH"	"12.999.01.001"	7	0	7
"210247"	"Blomenröhr Fahrzeugbau GmbH"	"12.999.01.003"	26	1	25
"210250"	"Bagela Baumaschinen GmbH & Co.KG"	"12.999.01.001"	12	0	12
"210305"	"Carnehl Fahrzeugbau"	"12.999.01.001"	49	1	48
"210305"	"Carnehl Fahrzeugbau"	"12.999.01.003"	-1	0	-1
"210305"	"Carnehl Fahrzeugbau"	"12.999.01.008"	9	0	9
"210305"	"Carnehl Fahrzeugbau"	"12.999.01.162"	40	0	40
"210305"	"Carnehl Fahrzeugbau"	"12.999.01.163"	10	0	10
"210305"	"Carnehl Fahrzeugbau"	"12.999.01.188"	21	0	21
"210507"	"EGGERS"	"12.999.01.001"	0	1	-1
"210507"	"EGGERS"	"12.999.01.003"	0	1	-1
"210602"	"FELDBINDER"	"12.999.01.001"	61	11	50
"210602"	"FELDBINDER"	"12.999.01.003"	-19	1	-20
"210602"	"FELDBINDER"	"12.999.01.008"	-3	4	-7
"210602"	"FELDBINDER"	"12.999.01.162"	19	10	9
"210602"	"FELDBINDER"	"12.999.01.163"	5	3	2
"210602"	"FELDBINDER"	"12.999.01.188"	90	33	57
"210613"	"WILHELM FRICKE GMBH"	"12.999.01.001"	0	2	-2
"210613"	"WILHELM FRICKE GMBH"	"12.999.01.003"	0	0	0
"210613"	"WILHELM FRICKE GMBH"	"12.999.01.008"	2	0	2
"210818"	"Hofmeister & Meincke GmbH & Co. KG"	"12.999.01.001"	20	3	17
"210818"	"Hofmeister & Meincke GmbH & Co. KG"	"12.999.01.003"	-64	3	-67
"210818"	"Hofmeister & Meincke GmbH & Co. KG"	"12.999.01.008"	1	0	1
"210833"	"A.-W. HEIL & SOHN GMBH & CO.KG"	"12.999.01.001"	1	1	0
"210845"	"HEINRICH HEUSER GMBH & CO. KG"	"12.999.01.001"	0	0	0
"210846"	"Heitling Fahrzeugbau GmbH & Co. KG"	"12.999.01.001"	1	0	1
"210849"	"HRD-TRAILER-ENGINEERING GMBH"	"12.999.01.001"	13	11	2
"210849"	"HRD-TRAILER-ENGINEERING GMBH"	"12.999.01.003"	2	2	0
"210849"	"HRD-TRAILER-ENGINEERING GMBH"	"12.999.01.008"	8	8	0
"210849"	"HRD-TRAILER-ENGINEERING GMBH"	"12.999.01.162"	16	12	4
"210849"	"HRD-TRAILER-ENGINEERING GMBH"	"12.999.01.163"	6	4	2
"210849"	"HRD-TRAILER-ENGINEERING GMBH"	"12.999.01.188"	7	7	0
"211005"	"OTTO JUST GMBH & CO. KG"	"12.999.01.001"	1	0	1
"211108"	"Köhler Fahrzeugbau GmbH & Co.KG"	"12.999.01.001"	2	1	1
"211108"	"Köhler Fahrzeugbau GmbH & Co.KG"	"12.999.01.003"	1	0	1
"211108"	"Köhler Fahrzeugbau GmbH & Co.KG"	"12.999.01.188"	1	1	0
"211122"	"EMMY KLOOSS"	"12.999.01.001"	6	0	6
"211123"	"PETER KROEGER GMBH"	"12.999.01.001"	1	0	1
"211130"	"Josef Kotte"	"12.999.01.003"	1	0	1
"211133"	"KRUKENMEIER GMBH"	"12.999.01.001"	4	0	4
"211133"	"KRUKENMEIER GMBH"	"12.999.01.003"	1	1	0
"211133"	"KRUKENMEIER GMBH"	"12.999.01.162"	4	4	0
"211133"	"KRUKENMEIER GMBH"	"12.999.01.163"	1	1	0
"211133"	"KRUKENMEIER GMBH"	"12.999.01.188"	2	0	2
"211134"	"KAR KUNZ"	"12.999.01.001"	-4	0	-4
"211134"	"KAR KUNZ"	"12.999.01.003"	2	0	2
"211136"	"Kedrowski Fahrzeugbau GmbH & Co. KG"	"12.999.01.001"	1	0	1
"211136"	"Kedrowski Fahrzeugbau GmbH & Co. KG"	"12.999.01.003"	1	0	1
"211325"	"MENKE-JANZEN"	"12.999.01.001"	35	1	34
"211325"	"MENKE-JANZEN"	"12.999.01.003"	-6	1	-7
"211325"	"MENKE-JANZEN"	"12.999.01.188"	2	1	1
"211613"	"PV Automotive GmbH"	"12.999.01.001"	5	1	4
"211613"	"PV Automotive GmbH"	"12.999.01.003"	2	0	2
"211906"	"SPIER  GMBH & CO."	"12.999.01.001"	5	11	-6
"211906"	"SPIER  GMBH & CO."	"12.999.01.003"	3	7	-4
"211906"	"SPIER  GMBH & CO."	"12.999.01.008"	12	8	4
"211906"	"SPIER  GMBH & CO."	"12.999.01.162"	28	24	4
"211906"	"SPIER  GMBH & CO."	"12.999.01.163"	7	6	1
"211906"	"SPIER  GMBH & CO."	"12.999.01.188"	2	0	2
"211915"	"JUERGEN STERN"	"12.999.01.001"	1	0	1
"212004"	"SCHROEDER"	"12.999.01.001"	1	1	0
"212004"	"SCHROEDER"	"12.999.01.003"	1	0	1
"212004"	"SCHROEDER"	"12.999.01.188"	1	1	0
"212010"	"SCHUETTE FAHRZEUGBAU GMBH"	"12.999.01.001"	1	1	0
"212010"	"SCHUETTE FAHRZEUGBAU GMBH"	"12.999.01.003"	1	1	0
"212012"	"KFB Jessen GmbH"	"12.999.01.001"	2	0	2
"212012"	"KFB Jessen GmbH"	"12.999.01.003"	2	0	2
"212020"	"E. SCHWAGMEIER KAROSSERIE- UND"	"12.999.01.001"	0	0	0
"212020"	"E. SCHWAGMEIER KAROSSERIE- UND"	"12.999.01.003"	0	0	0
"212109"	"Stehmann GmbH"	"12.999.01.001"	6	2	4
"212109"	"Stehmann GmbH"	"12.999.01.003"	6	3	3
"212109"	"Stehmann GmbH"	"12.999.01.188"	1	0	1
"212110"	"METALLBAU STAGGENBORG GMBH"	"12.999.01.001"	-5	0	-5
"212110"	"METALLBAU STAGGENBORG GMBH"	"12.999.01.003"	2	0	2
"212209"	"HERMANN TECHAU"	"12.999.01.001"	1	0	1
"212213"	"TOS TWIST"	"12.999.01.188"	0	0	0
"212508"	"WABCO GmbH & Co. OHG"	"12.999.01.001"	-74	0	-74
"212527"	"Wiese GmbH & Co. KG"	"12.999.01.001"	1	0	1
"212527"	"Wiese GmbH & Co. KG"	"12.999.01.003"	0	0	0
"212527"	"Wiese GmbH & Co. KG"	"12.999.01.188"	3	0	3
"212528"	"WILKEN"	"12.999.01.001"	0	0	0
"212528"	"WILKEN"	"12.999.01.003"	0	0	0
"212528"	"WILKEN"	"12.999.01.188"	5	2	3
"212534"	"Heinrich Wellmeyer Fahrzeugbau"	"12.999.01.001"	0	1	-1
"212534"	"Heinrich Wellmeyer Fahrzeugbau"	"12.999.01.003"	0	0	0
"212534"	"Heinrich Wellmeyer Fahrzeugbau"	"12.999.01.188"	6	0	6
"212535"	"Weka Fahrzeugbau GmbH"	"12.999.01.001"	48	2	46
"212535"	"Weka Fahrzeugbau GmbH"	"12.999.01.003"	4	1	3
"212535"	"Weka Fahrzeugbau GmbH"	"12.999.01.008"	6	0	6
"212535"	"Weka Fahrzeugbau GmbH"	"12.999.01.162"	6	0	6
"212535"	"Weka Fahrzeugbau GmbH"	"12.999.01.163"	2	0	2
"212535"	"Weka Fahrzeugbau GmbH"	"12.999.01.188"	20	2	18
"212536"	"Wilhelm Wellmeyer Fahrzeugbau"	"12.999.01.001"	0	0	0
"212536"	"Wilhelm Wellmeyer Fahrzeugbau"	"12.999.01.003"	0	0	0
"220116"	"ATV-ELMER GMBH & CO. KG"	"12.999.01.001"	2	0	2
"220116"	"ATV-ELMER GMBH & CO. KG"	"12.999.01.003"	2	0	2
"220118"	"AMAZONEN-WERKE"	"12.999.01.001"	10	0	10
"220118"	"AMAZONEN-WERKE"	"12.999.01.003"	3	0	3
"220118"	"AMAZONEN-WERKE"	"12.999.01.008"	3	0	3
"220205"	"Bierhake Fahrzeugteile"	"12.999.01.001"	7	0	7
"220210"	"BOECKER Maschinenwerke GmbH"	"12.999.01.001"	0	1	-1
"220228"	"Bohnenkamp AG"	"12.999.01.001"	5	0	5
"220252"	"PAUL BRUESER GMBH"	"12.999.01.001"	-1	19	-20
"220252"	"PAUL BRUESER GMBH"	"12.999.01.003"	-4	36	-40
"220252"	"PAUL BRUESER GMBH"	"12.999.01.008"	521	140	381
"220252"	"PAUL BRUESER GMBH"	"12.999.01.011"	3	0	3
"220254"	"BWO BEHINDERTEN-WERKSTAETTEN"	"12.999.01.001"	-21	24	-45
"220254"	"BWO BEHINDERTEN-WERKSTAETTEN"	"12.999.01.003"	77	26	51
"220254"	"BWO BEHINDERTEN-WERKSTAETTEN"	"12.999.01.008"	110	104	6
"220255"	"BWO BEHINDERTEN-WERSTAETTEN"	"12.999.01.001"	-77	0	-77
"220255"	"BWO BEHINDERTEN-WERSTAETTEN"	"12.999.01.003"	-38	5	-43
"220255"	"BWO BEHINDERTEN-WERSTAETTEN"	"12.999.01.008"	31	0	31
"220312"	"MANNSTAEDT GMBH & CO. KG"	"12.999.01.001"	6	4	2
"220312"	"MANNSTAEDT GMBH & CO. KG"	"12.999.01.003"	2	0	2
"220414"	"FAHRZEUGBAU DRUMANN GMBH"	"12.999.01.001"	1	0	1
"220414"	"FAHRZEUGBAU DRUMANN GMBH"	"12.999.01.003"	1	0	1
"220628"	"FONTANA GMBH"	"12.999.01.003"	-353	0	-353
"220628"	"FONTANA GMBH"	"12.999.01.008"	460	0	460
"220629"	"GEORG FISCHER GMBH & CO. KG"	"12.999.01.001"	-1	0	-1
"220629"	"GEORG FISCHER GMBH & CO. KG"	"12.999.01.003"	-5	0	-5
"220703"	"GOFA Gocher Fahrzeugbau GmbH"	"12.999.01.001"	15	4	11
"220703"	"GOFA Gocher Fahrzeugbau GmbH"	"12.999.01.003"	4	6	-2
"220703"	"GOFA Gocher Fahrzeugbau GmbH"	"12.999.01.008"	0	0	0
"220703"	"GOFA Gocher Fahrzeugbau GmbH"	"12.999.01.162"	4	0	4
"220703"	"GOFA Gocher Fahrzeugbau GmbH"	"12.999.01.188"	6	1	5
"220814"	"Beilharz Nutzfahrzeuge"	"12.999.01.001"	2	0	2
"220814"	"Beilharz Nutzfahrzeuge"	"12.999.01.003"	1	0	1
"220843"	"HEETMANN & FINKENSIEP"	"12.999.01.003"	-1	37	-38
"220843"	"HEETMANN & FINKENSIEP"	"12.999.01.008"	110	130	-20
"221113"	"Fahrzeugwerk Bernard Krone GmbH"	"12.999.01.001"	833	176	657
"221113"	"Fahrzeugwerk Bernard Krone GmbH"	"12.999.01.003"	205	49	156
"221113"	"Fahrzeugwerk Bernard Krone GmbH"	"12.999.01.008"	37	13	24
"221113"	"Fahrzeugwerk Bernard Krone GmbH"	"12.999.01.162"	159	208	-49
"221113"	"Fahrzeugwerk Bernard Krone GmbH"	"12.999.01.163"	45	56	-11
"221113"	"Fahrzeugwerk Bernard Krone GmbH"	"12.999.01.188"	488	419	69
"221114"	"KLAESER INTERN. FACHSPEDITION"	"12.999.01.001"	3	0	3
"221114"	"KLAESER INTERN. FACHSPEDITION"	"12.999.01.003"	6	0	6
"221114"	"KLAESER INTERN. FACHSPEDITION"	"12.999.01.188"	1	0	1
"221126"	"Kroll Fahrzeugbau-"	"12.999.01.188"	0	0	0
"221147"	"Krause GmbH"	"12.999.01.001"	0	0	0
"221207"	"LEVEN NUTZFAHRZEUGE"	"12.999.01.001"	5	0	5
"221207"	"LEVEN NUTZFAHRZEUGE"	"12.999.01.003"	2	0	2
"221213"	"Hermann Langfeld e.K."	"12.999.01.001"	8	1	7
"221213"	"Hermann Langfeld e.K."	"12.999.01.003"	2	1	1
"221213"	"Hermann Langfeld e.K."	"12.999.01.188"	7	1	6
"221214"	"LOECHTERFELD GMBH"	"12.999.01.001"	1	14	-13
"221214"	"LOECHTERFELD GMBH"	"12.999.01.003"	3	3	0
"221221"	"LANCIER CABLE GMBH"	"12.999.01.001"	2	0	2
"221229"	"LEMKEN GMBH & CO. KG"	"12.999.01.001"	1	0	1
"221229"	"LEMKEN GMBH & CO. KG"	"12.999.01.008"	5	0	5
"221233"	"LANGENDORF GmbH"	"12.999.01.001"	161	37	124
"221233"	"LANGENDORF GmbH"	"12.999.01.003"	8	2	6
"221233"	"LANGENDORF GmbH"	"12.999.01.008"	21	16	5
"221233"	"LANGENDORF GmbH"	"12.999.01.162"	-14	2	-16
"221233"	"LANGENDORF GmbH"	"12.999.01.163"	0	1	-1
"221233"	"LANGENDORF GmbH"	"12.999.01.188"	34	7	27
"221309"	"ANHAENGER- U. FAHRZEUGBAU"	"12.999.01.001"	8	5	3
"221309"	"ANHAENGER- U. FAHRZEUGBAU"	"12.999.01.008"	1	0	1
"221309"	"ANHAENGER- U. FAHRZEUGBAU"	"12.999.01.162"	0	0	0
"221309"	"ANHAENGER- U. FAHRZEUGBAU"	"12.999.01.163"	0	0	0
"221309"	"ANHAENGER- U. FAHRZEUGBAU"	"12.999.01.188"	9	5	4
"221326"	"Menke Agrar GmbH"	"12.999.01.001"	0	0	0
"221404"	"NTV NUTZFAHRZEUGTEILE"	"12.999.01.001"	10	6	4
"221404"	"NTV NUTZFAHRZEUGTEILE"	"12.999.01.003"	3	2	1
"221506"	"OSTERATH GMBH"	"12.999.01.003"	0	0	0
"221506"	"OSTERATH GMBH"	"12.999.01.188"	0	0	0
"221609"	"PV Automotive GmbH"	"12.999.01.003"	1	0	1
"221610"	"PV Automotive GmbH"	"12.999.01.001"	10	0	10
"221610"	"PV Automotive GmbH"	"12.999.01.003"	33	0	33
"221610"	"PV Automotive GmbH"	"12.999.01.008"	1	0	1
"221613"	"PV Automotive GmbH"	"12.999.01.003"	1	1	0
"221813"	"GEBR. RECKER GMBH"	"12.999.01.001"	2	0	2
"221813"	"GEBR. RECKER GMBH"	"12.999.01.162"	4	4	0
"221813"	"GEBR. RECKER GMBH"	"12.999.01.163"	1	1	0
"221815"	"RI-FA"	"12.999.01.001"	5	0	5
"221815"	"RI-FA"	"12.999.01.003"	2	0	2
"221907"	"SUER NUTZFAHRZEUGTECHNIK Gmbh & Co"	"12.999.01.001"	5	1	4
"221921"	"SIEPMANN-WERKE"	"12.999.01.001"	-1	0	-1
"222002"	"August Schmidt GmbH & Co. KG"	"12.999.01.001"	11	7	4
"222002"	"August Schmidt GmbH & Co. KG"	"12.999.01.003"	4	2	2
"222002"	"August Schmidt GmbH & Co. KG"	"12.999.01.188"	11	6	5
"222016"	"FORTUNA FAHRZEUGBAU GMBH & CO. KG"	"12.999.01.003"	0	0	0
"222018"	"WALTER SCHORK GMBH"	"12.999.01.001"	0	0	0
"222019"	"SCHMIDT KRAFTFAHRZEUG-"	"12.999.01.001"	2	3	-1
"222019"	"SCHMIDT KRAFTFAHRZEUG-"	"12.999.01.003"	0	0	0
"222030"	"SCHMITZ-CARGOBULL AG"	"12.999.01.001"	3	0	3
"222030"	"SCHMITZ-CARGOBULL AG"	"12.999.01.003"	-17	0	-17
"222030"	"SCHMITZ-CARGOBULL AG"	"12.999.01.162"	0	0	0
"222030"	"SCHMITZ-CARGOBULL AG"	"12.999.01.163"	0	0	0
"222030"	"SCHMITZ-CARGOBULL AG"	"12.999.01.188"	10	0	10
"222032"	"SCHMITZ-CARGOBULL AG"	"12.999.01.001"	-11	4	-15
"222032"	"SCHMITZ-CARGOBULL AG"	"12.999.01.003"	-5	0	-5
"222032"	"SCHMITZ-CARGOBULL AG"	"12.999.01.008"	1	0	1
"222032"	"SCHMITZ-CARGOBULL AG"	"12.999.01.162"	0	0	0
"222032"	"SCHMITZ-CARGOBULL AG"	"12.999.01.163"	0	0	0
"222032"	"SCHMITZ-CARGOBULL AG"	"12.999.01.188"	60	26	34
"222037"	"SCHRADER-T + A + Fahrzeugbau"	"12.999.01.001"	10	3	7
"222037"	"SCHRADER-T + A + Fahrzeugbau"	"12.999.01.008"	2	1	1
"222037"	"SCHRADER-T + A + Fahrzeugbau"	"12.999.01.188"	16	9	7
"222040"	"CARGOBULL"	"12.999.01.001"	0	17	-17
"222040"	"CARGOBULL"	"12.999.01.003"	0	1	-1
"222042"	"SCHMIEDAG GMBH"	"12.999.01.001"	16	0	16
"222203"	"KARL TANG GMBH"	"12.999.01.001"	0	0	0
"222203"	"KARL TANG GMBH"	"12.999.01.003"	0	0	0
"222204"	"GEBR. TITGEMEYER GMBH & CO. KG"	"12.999.01.001"	1	0	1
"222204"	"GEBR. TITGEMEYER GMBH & CO. KG"	"12.999.01.003"	5	0	5
"222216"	"Albert Tebbe GmbH"	"12.999.01.001"	3	1	2
"222216"	"Albert Tebbe GmbH"	"12.999.01.003"	2	1	1
"222540"	"WINKLER FAHRZEUGTEILE GMBH"	"12.999.01.001"	1	0	1
"222543"	"WECON"	"12.999.01.001"	23	1	22
"222543"	"WECON"	"12.999.01.003"	24	2	22
"222543"	"WECON"	"12.999.01.008"	3	0	3
"222543"	"WECON"	"12.999.01.162"	2	0	2
"222543"	"WECON"	"12.999.01.165"	2	0	2
"222543"	"WECON"	"12.999.01.188"	7	0	7
"222547"	"W+O NIETTECHNIK GMBH"	"12.999.01.001"	1	0	1
"222547"	"W+O NIETTECHNIK GMBH"	"12.999.01.003"	99	0	99
"222547"	"W+O NIETTECHNIK GMBH"	"12.999.01.008"	273	0	273
"223001"	"SCHOMAECKER FEDERNWERK GMBH"	"12.999.01.001"	71	0	71
"223001"	"SCHOMAECKER FEDERNWERK GMBH"	"12.999.01.003"	-543	0	-543
"223007"	"FEDERAL MOGUL"	"12.999.01.001"	0	10	-10
"223007"	"FEDERAL MOGUL"	"12.999.01.003"	0	20	-20
"223007"	"FEDERAL MOGUL"	"12.999.01.008"	0	51	-51
"223008"	"Rütgers GmbH & Co. KG"	"12.999.01.001"	2	0	2
"223008"	"Rütgers GmbH & Co. KG"	"12.999.01.003"	12	0	12
"223017"	"WESTFALEN AG"	"12.999.01.003"	0	1	-1
"230000"	"BPW Bergische Achsen"	"12.999.01.001"	18	93	-75
"230000"	"BPW Bergische Achsen"	"12.999.01.003"	40	6	34
"230000"	"BPW Bergische Achsen"	"12.999.01.008"	3	0	3
"240213"	"BERGER KAROSSERIE-"	"12.999.01.001"	1	0	1
"240213"	"BERGER KAROSSERIE-"	"12.999.01.003"	1	0	1
"240240"	"Benninghoven GmbH & Co KG"	"12.999.01.003"	5	0	5
"240505"	"DR. ING. ULRICH ESTERER GMBH & CO."	"12.999.01.001"	1	0	1
"240505"	"DR. ING. ULRICH ESTERER GMBH & CO."	"12.999.01.003"	18	0	18
"240518"	"EUROPART"	"12.999.01.001"	1	0	1
"240520"	"EUROPART  Trading GMBH"	"12.999.01.001"	1	0	1
"240522"	"EISEL NUTZFAHRZEUGE GMBH"	"12.999.01.001"	1	0	1
"240522"	"EISEL NUTZFAHRZEUGE GMBH"	"12.999.01.003"	1	0	1
"240522"	"EISEL NUTZFAHRZEUGE GMBH"	"12.999.01.188"	0	0	0
"240632"	"Fischer Fahrzeugbau GmbH"	"12.999.01.001"	1	0	1
"240733"	"GANGOLF NUTZFAHRZEUGE GMBH"	"12.999.01.001"	2	0	2
"240827"	"HEURICH"	"12.999.01.001"	1	0	1
"240827"	"HEURICH"	"12.999.01.003"	2	0	2
"241008"	"Jost  Werke GmbH"	"12.999.01.001"	-89	0	-89
"241008"	"Jost  Werke GmbH"	"12.999.01.003"	0	0	0
"241114"	"ERICH KERSTING GMBH & CO. KG"	"12.999.01.001"	2	0	2
"241114"	"ERICH KERSTING GMBH & CO. KG"	"12.999.01.003"	2	0	2
"241128"	"HERMANN KUEHN GMBH"	"12.999.01.001"	0	0	0
"241134"	"Fahrzeugbau Kempf GmbH"	"12.999.01.001"	82	47	35
"241134"	"Fahrzeugbau Kempf GmbH"	"12.999.01.003"	-6	2	-8
"241134"	"Fahrzeugbau Kempf GmbH"	"12.999.01.008"	1	1	0
"241134"	"Fahrzeugbau Kempf GmbH"	"12.999.01.188"	93	33	60
"241146"	"KEMPF FAHRZEUGBAU"	"12.999.01.001"	4	0	4
"241146"	"KEMPF FAHRZEUGBAU"	"12.999.01.188"	7	0	7
"241214"	"LUECK FAHRZEUGBAU GMBH"	"12.999.01.001"	3	0	3
"241214"	"LUECK FAHRZEUGBAU GMBH"	"12.999.01.003"	1	0	1
"241214"	"LUECK FAHRZEUGBAU GMBH"	"12.999.01.188"	3	0	3
"241216"	"LEISE GMBH & CO. KG"	"12.999.01.001"	1	1	0
"241216"	"LEISE GMBH & CO. KG"	"12.999.01.003"	1	0	1
"241217"	"KRAMP Groep B.V."	"12.999.01.001"	10	2	8
"241217"	"KRAMP Groep B.V."	"12.999.01.008"	1	0	1
"241325"	"WM SE"	"12.999.01.001"	0	0	0
"241328"	"A. MUELLER FAHRZEUGBAU GMBH"	"12.999.01.001"	3	0	3
"241328"	"A. MUELLER FAHRZEUGBAU GMBH"	"12.999.01.188"	2	0	2
"241349"	"F. MUELLER GMBH & CO. KG"	"12.999.01.001"	0	2	-2
"241349"	"F. MUELLER GMBH & CO. KG"	"12.999.01.003"	2	1	1
"241349"	"F. MUELLER GMBH & CO. KG"	"12.999.01.188"	0	1	-1
"241350"	"MENZER GMBH"	"12.999.01.001"	1	0	1
"241505"	"ORTEN GMBH & CO. KG"	"12.999.01.001"	1	0	1
"241505"	"ORTEN GMBH & CO. KG"	"12.999.01.003"	0	0	0
"241618"	"PROFI PARTS"	"12.999.01.001"	112	0	112
"241618"	"PROFI PARTS"	"12.999.01.003"	-8	0	-8
"241619"	"PROFI PARTS"	"12.999.01.001"	2	2	0
"241619"	"PROFI PARTS"	"12.999.01.003"	0	0	0
"241620"	"PROFI PARTS"	"12.999.01.001"	3	1	2
"241840"	"Dieter Röttger"	"12.999.01.001"	0	0	0
"241840"	"Dieter Röttger"	"12.999.01.003"	0	0	0
"241841"	"Winkler Logistik GmbH"	"12.999.01.001"	1	2	-1
"241841"	"Winkler Logistik GmbH"	"12.999.01.003"	0	2	-2
"242506"	"EUROPART  Trading GMBH"	"12.999.01.001"	1	0	1
"242516"	"WELLER GMBH & CO. KG"	"12.999.01.001"	0	1	-1
"242516"	"WELLER GMBH & CO. KG"	"12.999.01.003"	1	0	1
"242516"	"WELLER GMBH & CO. KG"	"12.999.01.008"	2	0	2
"242520"	"HEINRICH WEDEKIND &"	"12.999.01.001"	1	2	-1
"242520"	"HEINRICH WEDEKIND &"	"12.999.01.003"	1	1	0
"250212"	"BIRNER GMBH"	"12.999.01.001"	1	0	1
"250409"	"DIER & JAKOB"	"12.999.01.001"	3	0	3
"250611"	"FGS GMBH"	"12.999.01.001"	6	0	6
"250702"	"GOMM FAHRZEUGBAU GMBH"	"12.999.01.001"	0	0	0
"250702"	"GOMM FAHRZEUGBAU GMBH"	"12.999.01.003"	0	0	0
"250807"	"HONOLD GMBH & CO.KG"	"12.999.01.001"	1	0	1
"250807"	"HONOLD GMBH & CO.KG"	"12.999.01.188"	2	0	2
"250822"	"HIRTH FAHRZEUGBAU GMBH"	"12.999.01.001"	1	0	1
"251114"	"KOEPF FAHRZEUGBAU GMBH"	"12.999.01.188"	1	0	1
"251121"	"MASCHINENBAU KALTENBACH GMBH"	"12.999.01.001"	2	0	2
"251121"	"MASCHINENBAU KALTENBACH GMBH"	"12.999.01.003"	1	0	1
"251121"	"MASCHINENBAU KALTENBACH GMBH"	"12.999.01.188"	1	0	1
"251132"	"KAMAG"	"12.999.01.001"	1	0	1
"251132"	"KAMAG"	"12.999.01.003"	1	1	0
"251203"	"LIEBHERR-WERK"	"12.999.01.001"	4	0	4
"251203"	"LIEBHERR-WERK"	"12.999.01.003"	16	0	16
"251203"	"LIEBHERR-WERK"	"12.999.01.008"	1	0	1
"251208"	"L + M FAHRZEUGBAU GMBH"	"12.999.01.001"	0	1	-1
"251208"	"L + M FAHRZEUGBAU GMBH"	"12.999.01.003"	0	2	-2
"251306"	"Karl Mueller GmbH & Co. KG"	"12.999.01.001"	20	0	20
"251306"	"Karl Mueller GmbH & Co. KG"	"12.999.01.003"	25	0	25
"251306"	"Karl Mueller GmbH & Co. KG"	"12.999.01.008"	11	0	11
"251306"	"Karl Mueller GmbH & Co. KG"	"12.999.01.162"	8	0	8
"251306"	"Karl Mueller GmbH & Co. KG"	"12.999.01.163"	2	0	2
"251306"	"Karl Mueller GmbH & Co. KG"	"12.999.01.188"	8	0	8
"251317"	"MS-PARTS GMBH"	"12.999.01.001"	3	1	2
"251317"	"MS-PARTS GMBH"	"12.999.01.003"	8	2	6
"251317"	"MS-PARTS GMBH"	"12.999.01.188"	2	0	2
"251405"	"Neumayer Tekfor GmbH"	"12.999.01.001"	24	0	24
"251405"	"Neumayer Tekfor GmbH"	"12.999.01.003"	152	0	152
"251405"	"Neumayer Tekfor GmbH"	"12.999.01.008"	227	0	227
"251805"	"Winkler Logistik GmbH"	"12.999.01.001"	14	0	14
"251812"	"Winkler Logistik GmbH"	"12.999.01.001"	218	18	200
"251812"	"Winkler Logistik GmbH"	"12.999.01.003"	31	13	18
"251812"	"Winkler Logistik GmbH"	"12.999.01.008"	1	0	1
"251904"	"SPITZER"	"12.999.01.001"	5	1	4
"251904"	"SPITZER"	"12.999.01.003"	9	0	9
"251904"	"SPITZER"	"12.999.01.188"	52	2	50
"252018"	"SCHEUERLE"	"12.999.01.001"	2	0	2
"252018"	"SCHEUERLE"	"12.999.01.003"	11	4	7
"252020"	"SCHAEFER-TECHNIC GMBH"	"12.999.01.001"	0	1	-1
"252020"	"SCHAEFER-TECHNIC GMBH"	"12.999.01.003"	0	1	-1
"252029"	"AEBI SCHMIDT DEUTSCHLAND GMBH"	"12.999.01.001"	15	0	15
"252029"	"AEBI SCHMIDT DEUTSCHLAND GMBH"	"12.999.01.003"	49	0	49
"252029"	"AEBI SCHMIDT DEUTSCHLAND GMBH"	"12.999.01.008"	1	0	1
"252107"	"STAIGER NUTZFAHRZEUGE GMBH"	"12.999.01.001"	1	0	1
"252110"	"AUTOTEILE STREB GMBH"	"12.999.01.001"	2	0	2
"252110"	"AUTOTEILE STREB GMBH"	"12.999.01.003"	0	0	0
"252204"	"TROST AUTO SERVICE TECHNIK SE"	"12.999.01.001"	1	0	1
"252403"	"VETTER GMBH"	"12.999.01.001"	0	0	0
"252509"	"WINKLER Fahrzeugteile GmbH & Co.KG"	"12.999.01.001"	5	2	3
"252509"	"WINKLER Fahrzeugteile GmbH & Co.KG"	"12.999.01.003"	0	0	0
"252522"	"J. WILLIBALD"	"12.999.01.001"	1	0	1
"252522"	"J. WILLIBALD"	"12.999.01.003"	1	0	1
"252522"	"J. WILLIBALD"	"12.999.01.008"	1	0	1
"252702"	"ZIKUN FAHRZEUGBAU GMBH"	"12.999.01.001"	0	1	-1
"252702"	"ZIKUN FAHRZEUGBAU GMBH"	"12.999.01.003"	1	0	1
"252702"	"ZIKUN FAHRZEUGBAU GMBH"	"12.999.01.188"	11	3	8
"252704"	"GUSTAV ZIEGLER GMBH"	"12.999.01.001"	2	1	1
"252704"	"GUSTAV ZIEGLER GMBH"	"12.999.01.003"	1	1	0
"253032"	"KLUMPP & MUELLER GMBH & CO. KG"	"12.999.01.001"	1	0	1
"253032"	"KLUMPP & MUELLER GMBH & CO. KG"	"12.999.01.003"	1	0	1
"260216"	"BNT GMBH"	"12.999.01.001"	4	1	3
"260405"	"JOHANN DEMMLER KG"	"12.999.01.001"	0	1	-1
"260405"	"JOHANN DEMMLER KG"	"12.999.01.003"	0	3	-3
"260405"	"JOHANN DEMMLER KG"	"12.999.01.008"	0	0	0
"260502"	"ECKART Maschinenbau GmbH"	"12.999.01.001"	1	0	1
"260604"	"JOSEF FINKL KG"	"12.999.01.001"	1	0	1
"260613"	"FLIEGL FAHRZEUGBAU GMBH"	"12.999.01.001"	236	24	212
"260613"	"FLIEGL FAHRZEUGBAU GMBH"	"12.999.01.003"	64	7	57
"260613"	"FLIEGL FAHRZEUGBAU GMBH"	"12.999.01.008"	34	5	29
"260613"	"FLIEGL FAHRZEUGBAU GMBH"	"12.999.01.162"	-2	6	-8
"260613"	"FLIEGL FAHRZEUGBAU GMBH"	"12.999.01.163"	-4	2	-6
"260613"	"FLIEGL FAHRZEUGBAU GMBH"	"12.999.01.165"	8	0	8
"260613"	"FLIEGL FAHRZEUGBAU GMBH"	"12.999.01.188"	172	25	147
"260618"	"FLIEGL Agrartechnik GmbH"	"12.999.01.001"	1	0	1
"260618"	"FLIEGL Agrartechnik GmbH"	"12.999.01.003"	0	0	0
"260618"	"FLIEGL Agrartechnik GmbH"	"12.999.01.008"	12	0	12
"260618"	"FLIEGL Agrartechnik GmbH"	"12.999.01.162"	18	0	18
"260618"	"FLIEGL Agrartechnik GmbH"	"12.999.01.163"	16	0	16
"260618"	"FLIEGL Agrartechnik GmbH"	"12.999.01.188"	21	0	21
"260620"	"Fliegl Agro-Center GmbH"	"12.999.01.001"	0	0	0
"260702"	"JOSEF GEIDOBLER & SOHN GMBH"	"12.999.01.001"	0	0	0
"260702"	"JOSEF GEIDOBLER & SOHN GMBH"	"12.999.01.003"	0	0	0
"260704"	"Goldhofer Aktiengesellschaft"	"12.999.01.001"	16	10	6
"260704"	"Goldhofer Aktiengesellschaft"	"12.999.01.003"	-3	52	-55
"260704"	"Goldhofer Aktiengesellschaft"	"12.999.01.008"	5	0	5
"260704"	"Goldhofer Aktiengesellschaft"	"12.999.01.162"	-15	0	-15
"260704"	"Goldhofer Aktiengesellschaft"	"12.999.01.163"	2	0	2
"260704"	"Goldhofer Aktiengesellschaft"	"12.999.01.188"	1	0	1
"260714"	"GLOGGER FAHRZEUGBAU GMBH"	"12.999.01.001"	5	0	5
"260714"	"GLOGGER FAHRZEUGBAU GMBH"	"12.999.01.003"	20	0	20
"260803"	"HUTTNER"	"12.999.01.001"	2	1	1
"260803"	"HUTTNER"	"12.999.01.003"	2	0	2
"260811"	"HUMBAUR GMBH"	"12.999.01.001"	4	2	2
"260811"	"HUMBAUR GMBH"	"12.999.01.003"	7	2	5
"260811"	"HUMBAUR GMBH"	"12.999.01.008"	15	1	14
"260813"	"HOFMANN"	"12.999.01.001"	1	0	1
"260813"	"HOFMANN"	"12.999.01.003"	1	0	1
"260813"	"HOFMANN"	"12.999.01.188"	1	0	1
"261115"	"KAFFL Fahrzeugbau GmbH"	"12.999.01.001"	1	0	1
"261203"	"LINDNER & FISCHER"	"12.999.01.001"	6	1	5
"261203"	"LINDNER & FISCHER"	"12.999.01.008"	1	0	1
"261203"	"LINDNER & FISCHER"	"12.999.01.188"	6	1	5
"261305"	"ISM INDUSTRIESERVICE"	"12.999.01.001"	1	0	1
"261305"	"ISM INDUSTRIESERVICE"	"12.999.01.188"	1	0	1
"261312"	"MEUSBURGER"	"12.999.01.001"	432	4	428
"261312"	"MEUSBURGER"	"12.999.01.003"	405	1	404
"261312"	"MEUSBURGER"	"12.999.01.008"	35	0	35
"261312"	"MEUSBURGER"	"12.999.01.162"	140	8	132
"261312"	"MEUSBURGER"	"12.999.01.163"	55	3	52
"261312"	"MEUSBURGER"	"12.999.01.188"	47	1	46
"261606"	"Paul Nutzfahrzeuge GmbH"	"12.999.01.001"	2	0	2
"261606"	"Paul Nutzfahrzeuge GmbH"	"12.999.01.003"	6	0	6
"261608"	"POPP FAHRZEUGBAU GMBH"	"12.999.01.001"	0	1	-1
"261608"	"POPP FAHRZEUGBAU GMBH"	"12.999.01.003"	0	2	-2
"261802"	"MARTIN REISCH GMBH"	"12.999.01.001"	1	0	1
"261802"	"MARTIN REISCH GMBH"	"12.999.01.003"	10	0	10
"261802"	"MARTIN REISCH GMBH"	"12.999.01.162"	6	0	6
"261802"	"MARTIN REISCH GMBH"	"12.999.01.163"	2	0	2
"261802"	"MARTIN REISCH GMBH"	"12.999.01.188"	18	0	18
"261809"	"MARTIN REISCH GMBH"	"12.999.01.001"	17	8	9
"261809"	"MARTIN REISCH GMBH"	"12.999.01.003"	2	0	2
"261809"	"MARTIN REISCH GMBH"	"12.999.01.162"	24	0	24
"261809"	"MARTIN REISCH GMBH"	"12.999.01.163"	6	0	6
"261809"	"MARTIN REISCH GMBH"	"12.999.01.188"	12	0	12
"261818"	"NUTZFAHRZEUGE ROHR GMBH"	"12.999.01.001"	22	3	19
"261818"	"NUTZFAHRZEUGE ROHR GMBH"	"12.999.01.003"	4	1	3
"261818"	"NUTZFAHRZEUGE ROHR GMBH"	"12.999.01.188"	22	0	22
"261905"	"ZF SACHS AG"	"12.999.01.001"	-80	0	-80
"261905"	"ZF SACHS AG"	"12.999.01.003"	-5	0	-5
"262036"	"SCHMID FAHRZEUGBAU GMBH"	"12.999.01.001"	0	1	-1
"262036"	"SCHMID FAHRZEUGBAU GMBH"	"12.999.01.003"	1	2	-1
"262103"	"AUTOTEILE STREB"	"12.999.01.001"	4	0	4
"262217"	"TROST AUTO SERVICE TECHNIK SE"	"12.999.01.001"	1	0	1
"262217"	"TROST AUTO SERVICE TECHNIK SE"	"12.999.01.003"	2	0	2
"262506"	"KURT WILLIG GMBH & CO. KG"	"12.999.01.001"	1	0	1
"262506"	"KURT WILLIG GMBH & CO. KG"	"12.999.01.003"	3	0	3
"262509"	"WINKLER FAHRZEUGTEILE GMBH"	"12.999.01.001"	17	0	17
"262703"	"ZUNHAMMER GMBH"	"12.999.01.001"	9	0	9
"262703"	"ZUNHAMMER GMBH"	"12.999.01.003"	4	0	4
"262705"	"Zanner Fahrzeugbau GmbH"	"12.999.01.001"	0	0	0
"262706"	"ZEBU FAHRZEUGBAU GmbH & Co. KG"	"12.999.01.001"	1	0	1
"262706"	"ZEBU FAHRZEUGBAU GmbH & Co. KG"	"12.999.01.003"	1	0	1
"263015"	"BAYWA AG"	"12.999.01.001"	0	0	0
"270104"	"ANNABURGER NUTZFAHRZEUG GMBH"	"12.999.01.001"	2	1	1
"270104"	"ANNABURGER NUTZFAHRZEUG GMBH"	"12.999.01.003"	2	2	0
"270119"	"ACKERMANN FAHRZEUGBAU"	"12.999.01.001"	31	9	22
"270119"	"ACKERMANN FAHRZEUGBAU"	"12.999.01.003"	18	7	11
"270119"	"ACKERMANN FAHRZEUGBAU"	"12.999.01.188"	13	1	12
"270204"	"BEFA  BELZIGER-"	"12.999.01.001"	0	0	0
"270217"	"BBG BODENBEARBEITUNGSGERAETE"	"12.999.01.001"	0	0	0
"270404"	"Kurt Dinkel"	"12.999.01.001"	17	1	16
"270404"	"Kurt Dinkel"	"12.999.01.003"	0	0	0
"270404"	"Kurt Dinkel"	"12.999.01.188"	0	1	-1
"270513"	"Federn-Oßwald Fahrzeugteile &"	"12.999.01.003"	0	0	0
"270620"	"Feldbinder"	"12.999.01.001"	21	5	16
"270620"	"Feldbinder"	"12.999.01.003"	3	1	2
"270620"	"Feldbinder"	"12.999.01.008"	0	1	-1
"270620"	"Feldbinder"	"12.999.01.162"	8	0	8
"270620"	"Feldbinder"	"12.999.01.163"	3	0	3
"270620"	"Feldbinder"	"12.999.01.188"	19	3	16
"270623"	"RICHARD FEUCHTEMEYER"	"12.999.01.001"	0	0	0
"270623"	"RICHARD FEUCHTEMEYER"	"12.999.01.003"	0	0	0
"270624"	"FAG"	"12.999.01.001"	7	0	7
"270624"	"FAG"	"12.999.01.003"	2	3	-1
"270624"	"FAG"	"12.999.01.188"	4	0	4
"270804"	"Hüffermann"	"12.999.01.001"	37	13	24
"270804"	"Hüffermann"	"12.999.01.003"	8	5	3
"270804"	"Hüffermann"	"12.999.01.008"	2	1	1
"270804"	"Hüffermann"	"12.999.01.162"	65	8	57
"270804"	"Hüffermann"	"12.999.01.163"	7	2	5
"270804"	"Hüffermann"	"12.999.01.188"	17	14	3
"270805"	"HERZ NUTZFAHRZEUGTEILE GMBH"	"12.999.01.001"	0	2	-2
"270805"	"HERZ NUTZFAHRZEUGTEILE GMBH"	"12.999.01.003"	0	0	0
"270810"	"HKM FAHRZEUGBAU GMBH"	"12.999.01.001"	0	0	0
"270810"	"HKM FAHRZEUGBAU GMBH"	"12.999.01.003"	0	0	0
"270815"	"HELLMERS GMBH"	"12.999.01.001"	1	0	1
"270815"	"HELLMERS GMBH"	"12.999.01.188"	2	0	2
"271102"	"FRANK & SOHN"	"12.999.01.001"	0	0	0
"271112"	"KOTSCHENREUTHER FAHRZEUGBAU"	"12.999.01.001"	0	0	0
"271112"	"KOTSCHENREUTHER FAHRZEUGBAU"	"12.999.01.003"	0	0	0
"271114"	"Kirow Ardelt GmbH"	"12.999.01.003"	2	0	2
"271118"	"PLATAL MOBILSYSTEME GMBH"	"12.999.01.001"	1	0	1
"271118"	"PLATAL MOBILSYSTEME GMBH"	"12.999.01.003"	1	0	1
"271307"	"FMS Fahrzeugbau GmbH"	"12.999.01.001"	9	3	6
"271307"	"FMS Fahrzeugbau GmbH"	"12.999.01.003"	3	3	0
"271307"	"FMS Fahrzeugbau GmbH"	"12.999.01.162"	0	0	0
"271307"	"FMS Fahrzeugbau GmbH"	"12.999.01.163"	0	0	0
"271311"	"MAFA"	"12.999.01.001"	23	4	19
"271311"	"MAFA"	"12.999.01.008"	0	0	0
"271311"	"MAFA"	"12.999.01.163"	1	1	0
"271311"	"MAFA"	"12.999.01.188"	18	3	15
"271505"	"ORTEN GmbH & Co. KG"	"12.999.01.001"	1	0	1
"271505"	"ORTEN GmbH & Co. KG"	"12.999.01.003"	-1	1	-2
"271910"	"SAXAS"	"12.999.01.001"	2	1	1
"271910"	"SAXAS"	"12.999.01.008"	1	0	1
"272017"	"Schmitz Cargobull"	"12.999.01.001"	9	3	6
"272017"	"Schmitz Cargobull"	"12.999.01.008"	1	0	1
"272017"	"Schmitz Cargobull"	"12.999.01.188"	2	2	0
"272502"	"Schlosser Europart"	"12.999.01.001"	2	0	2
"272502"	"Schlosser Europart"	"12.999.01.003"	2	0	2
"272502"	"Schlosser Europart"	"12.999.01.008"	1	0	1
"272505"	"WILLIG FAHRZEUGBAU GMBH"	"12.999.01.001"	0	2	-2
"272505"	"WILLIG FAHRZEUGBAU GMBH"	"12.999.01.003"	0	1	-1
"272505"	"WILLIG FAHRZEUGBAU GMBH"	"12.999.01.008"	1	1	0
"272505"	"WILLIG FAHRZEUGBAU GMBH"	"12.999.01.188"	8	3	5
"272506"	"WESSEL-FAHRZEUGTEILE GMBH"	"12.999.01.001"	2	2	0
"272506"	"WESSEL-FAHRZEUGTEILE GMBH"	"12.999.01.003"	1	1	0
"272516"	"EUROPART  Trading GMBH"	"12.999.01.008"	0	1	-1
"280237"	"M. BUSCH GMBH & CO. KG"	"12.999.01.001"	0	0	0
"320006"	"OFFERGELD GMBH & CO."	"12.999.01.001"	1	0	1
"320037"	"Frye Transport-Logistik GMBH"	"12.999.01.001"	0	0	0
"320037"	"Frye Transport-Logistik GMBH"	"12.999.01.003"	-401	0	-401
"320080"	"GEORG KRAEMER FAHRZEUGBAU"	"12.999.01.001"	1	0	1
"320080"	"GEORG KRAEMER FAHRZEUGBAU"	"12.999.01.003"	1	0	1
"320102"	"NCG NUTZFAHRZEUG-CENTER GMBH"	"12.999.01.001"	1	0	1
"320132"	"KAMAX-WERKE"	"12.999.01.003"	-20	0	-20
"320132"	"KAMAX-WERKE"	"12.999.01.008"	461	0	461
"320147"	"JOHANNES REINERS"	"12.999.01.001"	1	0	1
"320150"	"Nagel-Group"	"12.999.01.001"	1	0	1
"320150"	"Nagel-Group"	"12.999.01.003"	2	0	2
"350003"	"FRITZ BRAUN FAHRZEUGBAU"	"12.999.01.001"	0	0	0
"350003"	"FRITZ BRAUN FAHRZEUGBAU"	"12.999.01.003"	0	0	0
"360132"	"P. SCHWANDNER"	"12.999.01.001"	1	1	0
"370002"	"SCANRO GMBH"	"12.999.01.001"	0	1	-1
"370046"	"Elflein Spedition & Transport GmbH"	"12.999.01.001"	1	0	1
"370046"	"Elflein Spedition & Transport GmbH"	"12.999.01.003"	1	0	1
"370175"	"Manfred Manig"	"12.999.01.001"	1	0	1
"390502"	"WINCANTON TRANS EUROPEAN (D) GmbH"	"12.999.01.003"	-4	0	-4
"390503"	"WIELAND-WERKE AG"	"12.999.01.001"	19	0	19
"390503"	"WIELAND-WERKE AG"	"12.999.01.003"	-58	0	-58
"390510"	"TMD FRICTION GMBH"	"12.999.01.001"	235	0	235
"390510"	"TMD FRICTION GMBH"	"12.999.01.003"	395	491	-96
"390510"	"TMD FRICTION GMBH"	"12.999.01.008"	807	30	777
"390511"	"SONA BLW"	"12.999.01.001"	4	0	4
"390511"	"SONA BLW"	"12.999.01.003"	-1	0	-1
"390513"	"THIEL & HOCHE GMBH & CO. KG"	"12.999.01.001"	35	30	5
"390513"	"THIEL & HOCHE GMBH & CO. KG"	"12.999.01.003"	24	0	24
"390513"	"THIEL & HOCHE GMBH & CO. KG"	"12.999.01.008"	77	0	77
"390514"	"THH DREHTEILE GMBH"	"12.999.01.001"	3	0	3
"390514"	"THH DREHTEILE GMBH"	"12.999.01.003"	-3	0	-3
"390516"	"ERICH SYDOW GMBH & CO. KG"	"12.999.01.003"	-1	0	-1
"390519"	"SKF GmbH"	"12.999.01.003"	189	0	189
"390525"	"SCHIEFFER GMBH & CO. KG"	"12.999.01.001"	64	30	34
"390525"	"SCHIEFFER GMBH & CO. KG"	"12.999.01.003"	-5	42	-47
"390525"	"SCHIEFFER GMBH & CO. KG"	"12.999.01.008"	97	120	-23
"390526"	"SCHENKER"	"12.999.01.001"	-26	0	-26
"390526"	"SCHENKER"	"12.999.01.003"	0	50	-50
"390528"	"ADOLF PUEHL GMBH & CO. KG"	"12.999.01.003"	-85	0	-85
"390530"	"PEINER UMFORMTECHNIK GMBH"	"12.999.01.003"	-72	33	-105
"390530"	"PEINER UMFORMTECHNIK GMBH"	"12.999.01.008"	1	330	-329
"390531"	"ALEXANDER PAAL GMBH"	"12.999.01.003"	-113	10	-123
"390531"	"ALEXANDER PAAL GMBH"	"12.999.01.008"	112	100	12
"390533"	"NEUHAUS"	"12.999.01.001"	87	0	87
"390533"	"NEUHAUS"	"12.999.01.003"	-92	0	-92
"390533"	"NEUHAUS"	"12.999.01.008"	239	0	239
"390534"	"TNT Innight GmbH & Co.KG"	"12.999.01.001"	60	14	46
"390534"	"TNT Innight GmbH & Co.KG"	"12.999.01.003"	4	0	4
"390537"	"MOHR + FRIEDRICH GMBH"	"12.999.01.001"	1	0	1
"390537"	"MOHR + FRIEDRICH GMBH"	"12.999.01.003"	-221	0	-221
"390537"	"MOHR + FRIEDRICH GMBH"	"12.999.01.008"	232	0	232
"390538"	"GUSTAV MEYER GMBH & CO."	"12.999.01.003"	6	0	6
"390538"	"GUSTAV MEYER GMBH & CO."	"12.999.01.008"	36	0	36
"390539"	"MAYER-JUMBO"	"12.999.01.001"	2	0	2
"390542"	"LST - GMBH"	"12.999.01.001"	-8	0	-8
"390542"	"LST - GMBH"	"12.999.01.003"	1	0	1
"390543"	"LIPPISCHE EISENINDUSTRIE GMBH"	"12.999.01.003"	-506	0	-506
"390543"	"LIPPISCHE EISENINDUSTRIE GMBH"	"12.999.01.008"	171	0	171
"390546"	"GESENK- UND FREIFORMSCHMIEDE"	"12.999.01.001"	-14	0	-14
"390555"	"KAUSEMANN GMBH"	"12.999.01.001"	6	0	6
"390556"	"JOHNSON DREHTECHNIK GMBH"	"12.999.01.003"	24	0	24
"390556"	"JOHNSON DREHTECHNIK GMBH"	"12.999.01.008"	34	0	34
"390557"	"WALTER HUNDHAUSEN GMBH"	"12.999.01.001"	-37	0	-37
"390557"	"WALTER HUNDHAUSEN GMBH"	"12.999.01.003"	-1	0	-1
"390560"	"HEINRICHS GMBH"	"12.999.01.001"	57	0	57
"390560"	"HEINRICHS GMBH"	"12.999.01.003"	14	2	12
"390560"	"HEINRICHS GMBH"	"12.999.01.008"	110	8	102
"390563"	"GUEDE GMBH"	"12.999.01.003"	-7	0	-7
"390563"	"GUEDE GMBH"	"12.999.01.008"	-28	0	-28
"390564"	"Heinrich Glane GmbH"	"12.999.01.001"	-13	8	-21
"390564"	"Heinrich Glane GmbH"	"12.999.01.003"	-673	3	-676
"390567"	"FUCHS SCHRAUBENWERK"	"12.999.01.003"	-36	9	-45
"390567"	"FUCHS SCHRAUBENWERK"	"12.999.01.008"	93	90	3
"390568"	"FORMTEIL- UND SCHRAUBENWERK"	"12.999.01.003"	139	0	139
"390569"	"AUGUST FRIEDBERG GMBH"	"12.999.01.003"	-224	0	-224
"390569"	"AUGUST FRIEDBERG GMBH"	"12.999.01.008"	243	0	243
"390570"	"FREUDENBERG SIMRIT KG"	"12.999.01.001"	-10	0	-10
"390570"	"FREUDENBERG SIMRIT KG"	"12.999.01.003"	-130	0	-130
"390571"	"ANDREAS FRANKE"	"12.999.01.003"	2	4	-2
"390572"	"Wälzlager GmbH"	"12.999.01.001"	1	0	1
"390572"	"Wälzlager GmbH"	"12.999.01.003"	20	33	-13
"390572"	"Wälzlager GmbH"	"12.999.01.008"	889	330	559
"390574"	"SAF-Holland GmbH"	"12.999.01.001"	21	0	21
"390574"	"SAF-Holland GmbH"	"12.999.01.003"	-11	0	-11
"390574"	"SAF-Holland GmbH"	"12.999.01.008"	90	0	90
"390575"	"FELDMANN-MAB"	"12.999.01.003"	-17	0	-17
"390575"	"FELDMANN-MAB"	"12.999.01.008"	13	0	13
"390576"	"CFS FALKENROTH UMFORMTECHNIK"	"12.999.01.001"	14	0	14
"390577"	"ESAB GMBH"	"12.999.01.003"	-183	0	-183
"390580"	"RUDOLF ECKEL"	"12.999.01.001"	11	0	11
"390580"	"RUDOLF ECKEL"	"12.999.01.003"	13	0	13
"390581"	"JOSEPH DRESSELHAUS"	"12.999.01.003"	-224	10	-234
"390581"	"JOSEPH DRESSELHAUS"	"12.999.01.008"	137	100	37
"390583"	"Obermann Logistik GmbH"	"12.999.01.003"	0	0	0
"390587"	"Sped. Dachser GmbH & Co. KG"	"12.999.01.003"	-1	0	-1
"404089"	"Rejna"	"12.999.01.001"	1	0	1
"404404"	"TPV d.d."	"12.999.01.001"	104	0	104
"406692"	"SLR-GUSSWERK II"	"12.999.01.001"	6	0	6
"408204"	"LECITRAILER S.A."	"12.999.01.001"	2	0	2
"408237"	"FUNDICIONES DE VERA S.A."	"12.999.01.001"	1	0	1
"408237"	"FUNDICIONES DE VERA S.A."	"12.999.01.003"	113	0	113
"408402"	"DRECHSEL & KOLLAR KFT"	"12.999.01.188"	0	0	0
"409002"	"F. X. MEILLER SLANY S.R.O."	"12.999.01.001"	15	14	1
"409002"	"F. X. MEILLER SLANY S.R.O."	"12.999.01.003"	-11	1	-12
"409002"	"F. X. MEILLER SLANY S.R.O."	"12.999.01.008"	2	2	0
"409002"	"F. X. MEILLER SLANY S.R.O."	"12.999.01.162"	0	0	0
"409002"	"F. X. MEILLER SLANY S.R.O."	"12.999.01.163"	0	0	0
"409002"	"F. X. MEILLER SLANY S.R.O."	"12.999.01.188"	30	23	7
"409004"	"BRANO A.S."	"12.999.01.001"	78	0	78
"409004"	"BRANO A.S."	"12.999.01.003"	4	0	4
"416670"	"FAHRZEUGBEDARF"	"12.999.01.001"	199	54	145
"416670"	"FAHRZEUGBEDARF"	"12.999.01.003"	423	144	279
"416670"	"FAHRZEUGBEDARF"	"12.999.01.008"	4	9	-5
"416670"	"FAHRZEUGBEDARF"	"12.999.01.162"	82	24	58
"416670"	"FAHRZEUGBEDARF"	"12.999.01.163"	20	1	19
"416674"	"Hendrickson Austria GmbH"	"12.999.01.001"	197	26	171
"416674"	"Hendrickson Austria GmbH"	"12.999.01.003"	2	227	-225
"428413"	"MOM Faktor"	"12.999.01.003"	0	0	0
"428413"	"MOM Faktor"	"12.999.01.008"	0	0	0
"490102"	"KUZNIA GLINIK SP.Z.O.O."	"12.999.01.001"	-15	0	-15
"490106"	"FORGING PRODUCTS S.A."	"12.999.01.001"	-42	0	-42
"490106"	"FORGING PRODUCTS S.A."	"12.999.01.003"	-56	0	-56
"490106"	"FORGING PRODUCTS S.A."	"12.999.01.008"	23	0	23
"490108"	"KAMAX S.R.O. TURNOV"	"12.999.01.003"	-34	0	-34
"490112"	"UNIOR DD"	"12.999.01.003"	92	0	92
"490112"	"UNIOR DD"	"12.999.01.008"	81	0	81
"500005"	"DUMMY-Sonderbestandsführer"	"12.999.01.001"	461	0	461
"500005"	"DUMMY-Sonderbestandsführer"	"12.999.01.003"	1	1	0
"500005"	"DUMMY-Sonderbestandsführer"	"12.999.01.008"	147	0	147
"500005"	"DUMMY-Sonderbestandsführer"	"12.999.01.011"	-2	0	-2
"500005"	"DUMMY-Sonderbestandsführer"	"12.999.01.188"	35	0	35
"500035"	"EUROPART Materials GmbH"	"12.999.01.001"	57	29	28
"500035"	"EUROPART Materials GmbH"	"12.999.01.003"	40	14	26
"500035"	"EUROPART Materials GmbH"	"12.999.01.008"	1	0	1
"500110"	"Karl Raudzus & Söhne"	"12.999.01.001"	0	0	0
"500118"	"Cargobull Parts & Services GmbH"	"12.999.01.001"	17	7	10
"500118"	"Cargobull Parts & Services GmbH"	"12.999.01.003"	3	0	3
"500167"	"MN Kaltformteile"	"12.999.01.003"	-11	0	-11
"500219"	"Georg Fischer GmbH"	"12.999.01.001"	-127	1	-128
"500219"	"Georg Fischer GmbH"	"12.999.01.003"	36	0	36
"500219"	"Georg Fischer GmbH"	"12.999.01.008"	79	0	79
"500245"	"NTV Nutzfahrzeuge"	"12.999.01.001"	2	0	2
"500304"	"EUROPART Trading GmbH"	"12.999.01.001"	0	0	0
"500310"	"Spermann Fahrzeugbau GmbH"	"12.999.01.001"	2	0	2
"500310"	"Spermann Fahrzeugbau GmbH"	"12.999.01.003"	2	0	2
"500318"	"Franz Fischer Spedition GmbH"	"12.999.01.003"	1	0	1
"500331"	"SW Umformtechnik"	"12.999.01.001"	22	0	22
"500331"	"SW Umformtechnik"	"12.999.01.003"	112	41	71
"500398"	"TROST AUTO SERVICE TECHNIK SE"	"12.999.01.003"	1	0	1
"500570"	"RI-FA"	"12.999.01.001"	2	0	2
"500570"	"RI-FA"	"12.999.01.003"	2	1	1
"500621"	"PROFI PARTS"	"12.999.01.001"	2	0	2
"500706"	"HGE Fahrzeugbau GmbH & Co. KG"	"12.999.01.001"	1	0	1
"500706"	"HGE Fahrzeugbau GmbH & Co. KG"	"12.999.01.188"	2	0	2
"500757"	"TROST AUTO SERVICE TECHNIK SE"	"12.999.01.001"	1	0	1
"500800"	"Paul Scholz KG"	"12.999.01.003"	0	1	-1
"500820"	"Hofmeister & Meincke GmbH & Co. KG"	"12.999.01.001"	1	0	1
"501044"	"Friedrich Kraft GmbH"	"12.999.01.001"	0	2	-2
"501044"	"Friedrich Kraft GmbH"	"12.999.01.003"	0	1	-1
"501100"	"Stürenberg Fahrzeugbau GmbH"	"12.999.01.001"	0	0	0
"501100"	"Stürenberg Fahrzeugbau GmbH"	"12.999.01.003"	0	0	0
"501146"	"Schwarzmüller"	"12.999.01.188"	41	0	41
"501210"	"WüTSCHNER"	"12.999.01.001"	0	0	0
"501210"	"WüTSCHNER"	"12.999.01.003"	0	0	0
"501221"	"Polyma Energiesysteme GmbH"	"12.999.01.001"	2	0	2
"501233"	"OPTIMAS OE Solutions GmbH"	"12.999.01.003"	-75	0	-75
"501233"	"OPTIMAS OE Solutions GmbH"	"12.999.01.008"	5	0	5
"501243"	"Altha Industrieprodukte"	"12.999.01.003"	21	0	21
"501243"	"Altha Industrieprodukte"	"12.999.01.008"	36	0	36
"501305"	"Kuznia Jawor SA"	"12.999.01.001"	24	0	24
"501398"	"BIRNER GMBH"	"12.999.01.001"	3	0	3
"501401"	"Bäumle Spedition GmbH"	"12.999.01.001"	1	0	1
"501401"	"Bäumle Spedition GmbH"	"12.999.01.003"	2	0	2
"501473"	"Herbert Dammann GmbH"	"12.999.01.001"	0	0	0
"501508"	"A-W.Heil & Sohn GmbH & Co."	"12.999.01.001"	34	4	30
"501508"	"A-W.Heil & Sohn GmbH & Co."	"12.999.01.003"	17	0	17
"501592"	"Paul Link GmbH & Co. KG"	"12.999.01.003"	0	1	-1
"501611"	"WM SE"	"12.999.01.003"	0	0	0
"501620"	"Fietz Thermoplast"	"12.999.01.003"	-17	0	-17
"501681"	"TROST AUTO SERVICE TECHNIK SE"	"12.999.01.001"	1	0	1
"502119"	"Claas Service and Parts GmbH"	"12.999.01.003"	0	0	0
"502119"	"Claas Service and Parts GmbH"	"12.999.01.008"	26	0	26
"502159"	"Kurt Willig"	"12.999.01.003"	0	0	0
"502219"	"Maschinenfabrik Bernard Krone GmbH"	"12.999.01.001"	3	0	3
"502219"	"Maschinenfabrik Bernard Krone GmbH"	"12.999.01.003"	1	1	0
"502219"	"Maschinenfabrik Bernard Krone GmbH"	"12.999.01.008"	0	0	0
"502560"	"Haerterei Hauck"	"12.999.01.001"	-7	0	-7
"502560"	"Haerterei Hauck"	"12.999.01.003"	-24	0	-24
"502560"	"Haerterei Hauck"	"12.999.01.008"	36	0	36
"502680"	"Finkl-Fahrzeugbau GmbH"	"12.999.01.001"	0	1	-1
"502680"	"Finkl-Fahrzeugbau GmbH"	"12.999.01.003"	0	4	-4
"502809"	"Franz Mersch GmbH & Co. KG"	"12.999.01.001"	1	1	0
"503038"	"Weißgerber/Seidner GmbH & Co"	"12.999.01.001"	78	20	58
"503038"	"Weißgerber/Seidner GmbH & Co"	"12.999.01.003"	97	0	97
"503131"	"Contitech Luftfedersysteme GmbH"	"12.999.01.001"	-4	0	-4
"503173"	"Bohnet GmbH"	"12.999.01.001"	5	0	5
"503208"	"Rainer Volk"	"12.999.01.001"	2	0	2
"503240"	"Wessels Vrees"	"12.999.01.001"	10	0	10
"503269"	"Sinco Tec"	"12.999.01.001"	4	0	4
"503313"	"Kaiser Fahrzeugbau GmbH"	"12.999.01.001"	0	2	-2
"503313"	"Kaiser Fahrzeugbau GmbH"	"12.999.01.003"	0	1	-1
"503313"	"Kaiser Fahrzeugbau GmbH"	"12.999.01.188"	1	1	0
"503356"	"Arnold Umformtechnik"	"12.999.01.003"	8	0	8
"503371"	"Heinrich Kruse"	"12.999.01.001"	1	0	1
"503490"	"B. Stade, Inh. M. Stade"	"12.999.01.003"	1	0	1
"503494"	"VCT Vogel GmbH"	"12.999.01.001"	1	2	-1
"503494"	"VCT Vogel GmbH"	"12.999.01.003"	1	0	1
"503494"	"VCT Vogel GmbH"	"12.999.01.188"	0	0	0
"503550"	"ForFarmers GmbH"	"12.999.01.003"	0	0	0
"503634"	"Wessels + Müller AG"	"12.999.01.001"	1	0	1
"503638"	"Fahrzeugbau GmbH Ladeburg"	"12.999.01.001"	0	0	0
"503638"	"Fahrzeugbau GmbH Ladeburg"	"12.999.01.003"	0	0	0
"503996"	"System Trailers GmbH"	"12.999.01.001"	71	10	61
"503996"	"System Trailers GmbH"	"12.999.01.003"	5	6	-1
"503996"	"System Trailers GmbH"	"12.999.01.008"	6	0	6
"503996"	"System Trailers GmbH"	"12.999.01.162"	20	0	20
"503996"	"System Trailers GmbH"	"12.999.01.163"	5	0	5
"503996"	"System Trailers GmbH"	"12.999.01.188"	64	33	31
"504155"	"Blumberg GmbH & Co. KG"	"12.999.01.003"	1	0	1
"504307"	"Zemmler"	"12.999.01.001"	5	1	4
"504307"	"Zemmler"	"12.999.01.003"	5	1	4
"504335"	"MAN Truck & Bus Deutschland GmbH"	"12.999.01.003"	0	1	-1
"504337"	"RUFA Fahrzeugbau GmbH"	"12.999.01.001"	11	5	6
"504337"	"RUFA Fahrzeugbau GmbH"	"12.999.01.003"	3	1	2
"504337"	"RUFA Fahrzeugbau GmbH"	"12.999.01.162"	0	0	0
"504337"	"RUFA Fahrzeugbau GmbH"	"12.999.01.163"	0	0	0
"504337"	"RUFA Fahrzeugbau GmbH"	"12.999.01.188"	11	3	8
"504462"	"TMD Friction  GmbH Coswig"	"12.999.01.003"	3	0	3
"504483"	"Streicher Landmaschinen GmbH"	"12.999.01.001"	1	0	1
"504659"	"Hellmut Schmied Spedition"	"12.999.01.003"	1	0	1
"504689"	"HS-Schoch GmbH"	"12.999.01.001"	-83	0	-83
"504689"	"HS-Schoch GmbH"	"12.999.01.003"	-215	0	-215
"504728"	"Grimme Landmaschinentechnik"	"12.999.01.001"	11	0	11
"504728"	"Grimme Landmaschinentechnik"	"12.999.01.003"	1	0	1
"504728"	"Grimme Landmaschinentechnik"	"12.999.01.008"	4	0	4
"504824"	"Spedition Eberhard Gersch"	"12.999.01.003"	0	1	-1
"504864"	"Lenicker GmbH"	"12.999.01.001"	2	0	2
"504880"	"Lisi Automotive-Knipping"	"12.999.01.003"	-11	0	-11
"504902"	"Peter Ortmann"	"12.999.01.001"	1	1	0
"505139"	"Karosserie- u. Fahrzeugbau"	"12.999.01.001"	0	0	0
"505149"	"A. Sedlmaier GmbH"	"12.999.01.003"	0	0	0
"505279"	"Reiner Reichert"	"12.999.01.001"	1	0	1
"505279"	"Reiner Reichert"	"12.999.01.188"	2	0	2
"505303"	"Kurt Willig GmbH & Co. KG"	"12.999.01.001"	-2	0	-2
"505303"	"Kurt Willig GmbH & Co. KG"	"12.999.01.003"	1	0	1
"505303"	"Kurt Willig GmbH & Co. KG"	"12.999.01.162"	0	0	0
"505303"	"Kurt Willig GmbH & Co. KG"	"12.999.01.163"	0	0	0
"505303"	"Kurt Willig GmbH & Co. KG"	"12.999.01.188"	15	0	15
"505463"	"Nutzfahrzeug & Service"	"12.999.01.001"	0	0	0
"505463"	"Nutzfahrzeug & Service"	"12.999.01.188"	0	0	0
"505485"	"ELHA Maschinenbau"	"12.999.01.001"	-7	0	-7
"505485"	"ELHA Maschinenbau"	"12.999.01.003"	2	0	2
"505515"	"RMW Rotenburger"	"12.999.01.003"	34	0	34
"505519"	"Brueggen Komponenten GmbH"	"12.999.01.001"	699	51	648
"505519"	"Brueggen Komponenten GmbH"	"12.999.01.003"	19	4	15
"505519"	"Brueggen Komponenten GmbH"	"12.999.01.008"	38	2	36
"505519"	"Brueggen Komponenten GmbH"	"12.999.01.162"	16	0	16
"505519"	"Brueggen Komponenten GmbH"	"12.999.01.163"	3	0	3
"505519"	"Brueggen Komponenten GmbH"	"12.999.01.188"	218	61	157
"505548"	"Colombo Special Fasteners"	"12.999.01.003"	33	27	6
"505548"	"Colombo Special Fasteners"	"12.999.01.008"	101	70	31
"505567"	"HOYER"	"12.999.01.001"	0	0	0
"505633"	"Europart Trading GmbH"	"12.999.01.001"	0	0	0
"505663"	"Schaeffler  KG"	"12.999.01.003"	-1	0	-1
"505664"	"Springfix"	"12.999.01.003"	24	0	24
"505666"	"Pöppelmann GmbH & Co."	"12.999.01.001"	0	1	-1
"505666"	"Pöppelmann GmbH & Co."	"12.999.01.003"	-14	0	-14
"505668"	"Willi Hahn GmbH"	"12.999.01.003"	-9	0	-9
"505695"	"Knoll GmbH"	"12.999.01.001"	-2	0	-2
"505735"	"Südbeck"	"12.999.01.001"	1	0	1
"505737"	"Vollmer + Boch"	"12.999.01.001"	19	0	19
"505737"	"Vollmer + Boch"	"12.999.01.003"	46	0	46
"505738"	"Mildner Fahrzeugbau GmbH"	"12.999.01.001"	44	7	37
"505738"	"Mildner Fahrzeugbau GmbH"	"12.999.01.003"	10	9	1
"505738"	"Mildner Fahrzeugbau GmbH"	"12.999.01.008"	6	4	2
"505738"	"Mildner Fahrzeugbau GmbH"	"12.999.01.188"	2	0	2
"505856"	"CT Kran-Cervice GmbH"	"12.999.01.001"	2	0	2
"505910"	"Wilhelm Schauerte"	"12.999.01.001"	-20	0	-20
"505910"	"Wilhelm Schauerte"	"12.999.01.003"	9	0	9
"505910"	"Wilhelm Schauerte"	"12.999.01.008"	8	0	8
"505994"	"Thimm Verpackung GmbH & Co."	"12.999.01.003"	0	0	0
"506215"	"Walter Fink"	"12.999.01.001"	1	0	1
"506371"	"LS Kunststofftechnologie GmbH"	"12.999.01.003"	7	0	7
"506466"	"BayWa AG Obertraubling"	"12.999.01.001"	1	0	1
"506695"	"Rauch Landmaschinenfabrik Gmbh"	"12.999.01.008"	1	0	1
"506832"	"Johann Vitz GmbH & Co. KG"	"12.999.01.003"	-8	0	-8
"506991"	"Eurotank GmbH"	"12.999.01.001"	7	2	5
"506991"	"Eurotank GmbH"	"12.999.01.008"	1	0	1
"506991"	"Eurotank GmbH"	"12.999.01.188"	5	0	5
"507063"	"Liebherr-Mischtechnik GmbH"	"12.999.01.003"	2	1	1
"507254"	"TH Baumaschinen"	"12.999.01.001"	0	0	0
"507427"	"Heinrich Stratmann GmbH"	"12.999.01.003"	1	0	1
"507513"	"Gottschalk GmbH"	"12.999.01.001"	0	0	0
"507513"	"Gottschalk GmbH"	"12.999.01.003"	0	0	0
"507539"	"Benninghoven"	"12.999.01.003"	2	0	2
"507597"	"Kögel Trailer GmbH & Co. KG"	"12.999.01.001"	38	3	35
"507597"	"Kögel Trailer GmbH & Co. KG"	"12.999.01.003"	3	0	3
"507597"	"Kögel Trailer GmbH & Co. KG"	"12.999.01.008"	4	0	4
"507597"	"Kögel Trailer GmbH & Co. KG"	"12.999.01.162"	4	0	4
"507597"	"Kögel Trailer GmbH & Co. KG"	"12.999.01.163"	1	0	1
"507597"	"Kögel Trailer GmbH & Co. KG"	"12.999.01.188"	149	18	131
"507646"	"Mager GmbH"	"12.999.01.001"	-12	0	-12
"507646"	"Mager GmbH"	"12.999.01.003"	4	0	4
"507646"	"Mager GmbH"	"12.999.01.008"	19	0	19
"507679"	"Amazone Technologie Leeden"	"12.999.01.008"	1	0	1
"507683"	"MTE"	"12.999.01.001"	1	0	1
"507737"	"Möller Fahrzeugbau"	"12.999.01.001"	1	0	1
"507737"	"Möller Fahrzeugbau"	"12.999.01.008"	1	0	1
"507738"	"Eckstein GmbH & Co.KG"	"12.999.01.001"	8	0	8
"507738"	"Eckstein GmbH & Co.KG"	"12.999.01.003"	13	0	13
"507778"	"Breuer & Wasel GmbH"	"12.999.01.001"	1	0	1
"507852"	"Müller Fahrzeugbau GmbH"	"12.999.01.003"	0	0	0
"508122"	"Reinhard Darming"	"12.999.01.003"	1	1	0
"508162"	"Zuern Harvesting GmbH & Co. KG"	"12.999.01.001"	5	0	5
"508219"	"TROST AUTO SERVICE TECHNIK SE"	"12.999.01.001"	23	9	14
"508219"	"TROST AUTO SERVICE TECHNIK SE"	"12.999.01.003"	2	1	1
"508293"	"Pankoke & Roll GmbH & Co.KG"	"12.999.01.001"	3	0	3
"508535"	"Blomenröhr Fahrzeugbau"	"12.999.01.001"	1	0	1
"508535"	"Blomenröhr Fahrzeugbau"	"12.999.01.003"	1	0	1
"508628"	"Beilharz Nutzfahrzeuge Duisburg Gmb"	"12.999.01.001"	13	0	13
"508628"	"Beilharz Nutzfahrzeuge Duisburg Gmb"	"12.999.01.003"	4	2	2
"508794"	"Agravis Technik Saltenbrock GmbH"	"12.999.01.001"	1	0	1
"508946"	"He - Wa Aufbau"	"12.999.01.001"	5	0	5
"508946"	"He - Wa Aufbau"	"12.999.01.003"	4	0	4
"508946"	"He - Wa Aufbau"	"12.999.01.008"	3	0	3
"508979"	"Lemmer GmbH & Co. KG"	"12.999.01.001"	-84	0	-84
"508979"	"Lemmer GmbH & Co. KG"	"12.999.01.003"	89	0	89
"508979"	"Lemmer GmbH & Co. KG"	"12.999.01.008"	40	0	40
"509379"	"Vibracoustic CV Air Springs"	"12.999.01.001"	-197	480	-677
"509379"	"Vibracoustic CV Air Springs"	"12.999.01.003"	18	0	18
"509379"	"Vibracoustic CV Air Springs"	"12.999.01.008"	22	0	22
"509460"	"Frauenthal Automotive"	"12.999.01.001"	75	0	75
"509460"	"Frauenthal Automotive"	"12.999.01.003"	14	0	14
"509460"	"Frauenthal Automotive"	"12.999.01.008"	100	0	100
"509494"	"TIP Trailer Services Germany GmbH"	"12.999.01.003"	0	2	-2
"509890"	"HZ - Elbe Autoersatzt.. GmbH & CO."	"12.999.01.001"	1	0	1
"509953"	"PM Hermann Perk"	"12.999.01.001"	2	0	2
"509953"	"PM Hermann Perk"	"12.999.01.008"	1	0	1
"510352"	"Autohaus Anders GmbH"	"12.999.01.001"	1	0	1
"510569"	"FLEXIMOL"	"12.999.01.001"	134	0	134
"510569"	"FLEXIMOL"	"12.999.01.003"	-3	0	-3
"510782"	"Hanisch GmbH"	"12.999.01.003"	0	0	0
"510946"	"Sebastian Obermaier"	"12.999.01.001"	1	0	1
"510946"	"Sebastian Obermaier"	"12.999.01.003"	1	0	1
"511312"	"HNT Härtling"	"12.999.01.001"	0	0	0
"511327"	"Rübsam & Co."	"12.999.01.001"	3	0	3
"511327"	"Rübsam & Co."	"12.999.01.008"	11	0	11
"511368"	"M Reithelshöfer GMBH"	"12.999.01.001"	1	0	1
"511885"	"CIMC Silvergreen Germany GmbH"	"12.999.01.001"	1	0	1
"511885"	"CIMC Silvergreen Germany GmbH"	"12.999.01.188"	23	0	23
"511928"	"Kögel, s. r. o."	"12.999.01.001"	-28	0	-28
"511928"	"Kögel, s. r. o."	"12.999.01.003"	2	0	2
"512068"	"SIGA Fahrzeugtechnik"	"12.999.01.188"	1	0	1
"512338"	"H & W"	"12.999.01.001"	4	5	-1
"512338"	"H & W"	"12.999.01.003"	0	9	-9
"512338"	"H & W"	"12.999.01.008"	1	4	-3
"512338"	"H & W"	"12.999.01.162"	6	0	6
"512338"	"H & W"	"12.999.01.163"	2	0	2
"512338"	"H & W"	"12.999.01.188"	5	0	5
"512578"	"TBZ GmbH"	"12.999.01.001"	6	1	5
"512578"	"TBZ GmbH"	"12.999.01.003"	6	1	5
"512611"	"K+G tec GmbH"	"12.999.01.001"	3	1	2
"512611"	"K+G tec GmbH"	"12.999.01.188"	3	3	0
"512620"	"Fellechner Fahrzeugbau GmbH"	"12.999.01.001"	8	2	6
"512620"	"Fellechner Fahrzeugbau GmbH"	"12.999.01.003"	2	2	0
"512620"	"Fellechner Fahrzeugbau GmbH"	"12.999.01.008"	2	0	2
"512620"	"Fellechner Fahrzeugbau GmbH"	"12.999.01.188"	2	1	1
"512789"	"Huster GmbH"	"12.999.01.001"	0	0	0
"512847"	"GEREP"	"12.999.01.001"	-10	0	-10
"512941"	"E. Heidrich"	"12.999.01.001"	1	0	1
"512945"	"Wagner GmbH"	"12.999.01.001"	0	0	0
"513076"	"Spedition Calenberg"	"12.999.01.001"	3	0	3
"513211"	"Schuler Fahrzeugbau GmbH"	"12.999.01.001"	6	1	5
"513211"	"Schuler Fahrzeugbau GmbH"	"12.999.01.162"	0	0	0
"513211"	"Schuler Fahrzeugbau GmbH"	"12.999.01.163"	0	0	0
"513721"	"Kumm Technik GmbH"	"12.999.01.001"	1	0	1
"513721"	"Kumm Technik GmbH"	"12.999.01.003"	2	0	2
"513775"	"Kreitz"	"12.999.01.001"	1	0	1
"514085"	"NTV Nutzfahrzeugteile Oesterhaus KG"	"12.999.01.001"	1	1	0
"514123"	"Michael Kumm GmbH"	"12.999.01.001"	0	0	0
"514300"	"Otto Fuchs KG"	"12.999.01.003"	10	15	-5
"514300"	"Otto Fuchs KG"	"12.999.01.008"	99	0	99
"514346"	"Prodinger oHG"	"12.999.01.003"	0	0	0
"514535"	"CTJ Janssen GmbH"	"12.999.01.001"	1	0	1
"514868"	"BMD Baumechanisierung"	"12.999.01.001"	1	0	1
"518187"	"Modschiedler Logistik GmbH"	"12.999.01.001"	1	0	1
"520059"	"BST - Transporte"	"12.999.01.001"	1	0	1
"520059"	"BST - Transporte"	"12.999.01.003"	2	0	2
"520549"	"Georg Wagner KG"	"12.999.01.001"	3	0	3
"520549"	"Georg Wagner KG"	"12.999.01.003"	4	0	4
"522748"	"Grieshaber Logistik AG"	"12.999.01.001"	1	0	1
"523639"	"Hofmeister & Meincke GmbH & Co.KG"	"12.999.01.001"	1	1	0
"523733"	"TAXO-Obermaier  GmbH"	"12.999.01.003"	8	0	8
"523740"	"Fasieco GmbH"	"12.999.01.001"	2	0	2
"523768"	"Moehling GmbH"	"12.999.01.003"	-34	5	-39
"523768"	"Moehling GmbH"	"12.999.01.008"	70	36	34
"523926"	"Forma Maschinenbau"	"12.999.01.001"	16	0	16
"523926"	"Forma Maschinenbau"	"12.999.01.008"	12	0	12
"523992"	"Dennis Struß"	"12.999.01.001"	1	0	1
"524088"	"ZAL GmbH"	"12.999.01.001"	1	0	1
"524141"	"Karl Groll GmbH + Co. KG"	"12.999.01.001"	3	0	3
"524459"	"Schreibmüller"	"12.999.01.001"	1	0	1
"524459"	"Schreibmüller"	"12.999.01.003"	1	0	1
"524464"	"Schondelmaier GmbH"	"12.999.01.001"	20	0	20
"524464"	"Schondelmaier GmbH"	"12.999.01.003"	1	0	1
"524478"	"Vibracoustic Polska SP. ZO.O."	"12.999.01.001"	1	0	1
"524478"	"Vibracoustic Polska SP. ZO.O."	"12.999.01.003"	8	0	8
"524507"	"Landwirtschaftsbetrieb Rienitz"	"12.999.01.003"	1	0	1
"524507"	"Landwirtschaftsbetrieb Rienitz"	"12.999.01.008"	1	0	1
"524612"	"Schuler Spezialfahrzeuge GmbH"	"12.999.01.001"	0	0	0
"524775"	"Neumeister Hydraulik GmbH"	"12.999.01.001"	5	0	5
"524775"	"Neumeister Hydraulik GmbH"	"12.999.01.003"	1	0	1
"524775"	"Neumeister Hydraulik GmbH"	"12.999.01.008"	7	0	7
"525106"	"Trost Auto Service Technik"	"12.999.01.001"	5	0	5
"525106"	"Trost Auto Service Technik"	"12.999.01.003"	3	0	3
"525395"	"Toni Hotz Transporte"	"12.999.01.001"	3	0	3
"525422"	"Rasche"	"12.999.01.001"	-17	0	-17
"525611"	"Massfeller GmbH"	"12.999.01.001"	2	0	2
"525936"	"Wolfgang Wagenblast"	"12.999.01.001"	1	0	1
"526093"	"Zachler Transport"	"12.999.01.003"	0	0	0
"526214"	"JW-TEC"	"12.999.01.001"	0	0	0
"526214"	"JW-TEC"	"12.999.01.188"	0	0	0
"526228"	"BC Trans GmbH & Co. KG"	"12.999.01.001"	1	0	1
"526372"	"Trost Auto Service Technik SE"	"12.999.01.001"	58	11	47
"526372"	"Trost Auto Service Technik SE"	"12.999.01.003"	56	1	55
"526405"	"Unipro"	"12.999.01.001"	1	0	1
"526481"	"ASEAG GmbH"	"12.999.01.001"	1	0	1
"526506"	"BHC Gummi-Metall GmbH"	"12.999.01.001"	-38	0	-38
"526506"	"BHC Gummi-Metall GmbH"	"12.999.01.003"	-5	0	-5
"526506"	"BHC Gummi-Metall GmbH"	"12.999.01.008"	-14	0	-14
"527504"	"AI Metalltechnik GmbH & Co. KG"	"12.999.01.001"	9	2	7
"527641"	"Winkler Fahrzeugteile GmbH"	"12.999.01.001"	0	0	0
"527678"	"SVG Autohof Stuttgart-Wangen"	"12.999.01.001"	1	0	1
"527681"	"A.-W. Heil & Sohn GmbH & Co. KG"	"12.999.01.001"	0	1	-1
"527702"	"Wütschner Fahrzeugteile GmbH"	"12.999.01.001"	0	1	-1
"527818"	"WM SE"	"12.999.01.001"	9	0	9
"527818"	"WM SE"	"12.999.01.003"	7	2	5
"528226"	"Rotor Clip"	"12.999.01.003"	-55	0	-55
"528226"	"Rotor Clip"	"12.999.01.008"	90	0	90
"528272"	"Pagenkopf Fahrzeugtechnik"	"12.999.01.001"	10	0	10
"528272"	"Pagenkopf Fahrzeugtechnik"	"12.999.01.003"	14	0	14
"528429"	"NICO Fahrzeugteile GmbH"	"12.999.01.001"	0	0	0
"528585"	"AUTO BRAND S.R.L."	"12.999.01.001"	5	0	5
"528585"	"AUTO BRAND S.R.L."	"12.999.01.008"	3	0	3
"528653"	"FVG GmbH & Co. KG"	"12.999.01.001"	6	0	6
"528653"	"FVG GmbH & Co. KG"	"12.999.01.003"	2	1	1
"528693"	"Profi-Parts"	"12.999.01.001"	2	0	2
"528771"	"Zanner Fahrzeugbau GmbH"	"12.999.01.001"	2	0	2
"528771"	"Zanner Fahrzeugbau GmbH"	"12.999.01.003"	1	0	1
"528940"	"F.X. MEILLER GmbH & Co. KG"	"12.999.01.001"	2	0	2
"528940"	"F.X. MEILLER GmbH & Co. KG"	"12.999.01.003"	2	0	2
"529079"	"sfb Schönebecker Fahrzeugbau GmbH"	"12.999.01.003"	0	0	0
"529163"	"Frimatec Ing. GmbH"	"12.999.01.003"	0	4	-4
"529351"	"Bavaria Schweisstechnik"	"12.999.01.001"	112	0	112
"529351"	"Bavaria Schweisstechnik"	"12.999.01.003"	-76	0	-76
"529383"	"Gabler Transport & Handel"	"12.999.01.001"	1	0	1
"529513"	"DOLL"	"12.999.01.001"	-30	15	-45
"529513"	"DOLL"	"12.999.01.003"	12	5	7
"529513"	"DOLL"	"12.999.01.008"	0	4	-4
"529513"	"DOLL"	"12.999.01.162"	22	10	12
"529513"	"DOLL"	"12.999.01.163"	9	4	5
"529513"	"DOLL"	"12.999.01.188"	10	2	8
"529520"	"Doll Sachsen GmbH"	"12.999.01.001"	7	1	6
"529520"	"Doll Sachsen GmbH"	"12.999.01.003"	14	0	14
"529520"	"Doll Sachsen GmbH"	"12.999.01.008"	2	0	2
"529520"	"Doll Sachsen GmbH"	"12.999.01.162"	4	0	4
"529520"	"Doll Sachsen GmbH"	"12.999.01.163"	1	0	1
"529520"	"Doll Sachsen GmbH"	"12.999.01.188"	2	0	2
"529551"	"Stefan Kohrs"	"12.999.01.001"	1	0	1
"529666"	"Wilhelm Severt Maschinenbau GmbH"	"12.999.01.001"	2	0	2
"529666"	"Wilhelm Severt Maschinenbau GmbH"	"12.999.01.003"	2	0	2
"529734"	"Max Streicher GmbH & Co."	"12.999.01.001"	2	0	2
"529741"	"Firestone Industrial Products"	"12.999.01.001"	79	90	-11
"529864"	"WEISSENBURG Industrie-Technik"	"12.999.01.003"	0	0	0
"529894"	"Freidrich Kraft GmbH"	"12.999.01.001"	1	0	1
"529894"	"Freidrich Kraft GmbH"	"12.999.01.003"	1	0	1
"529947"	"Haas Fahrzeugtechnik GmbH"	"12.999.01.001"	0	1	-1
"529947"	"Haas Fahrzeugtechnik GmbH"	"12.999.01.003"	2	1	1
"529985"	"Luhn & Pulvermacher"	"12.999.01.001"	24	0	24
"529986"	"LEISE GMBH & CO. KG"	"12.999.01.001"	3	0	3
"530076"	"Dreher und Schulz GbR"	"12.999.01.001"	1	0	1
"530172"	"GOTRADE L.L.C."	"12.999.01.003"	1	0	1
"530183"	"Hermann Fliess & Co. GmbH"	"12.999.01.003"	-36	0	-36
"530310"	"Josef König-Krölleke"	"12.999.01.001"	1	0	1
"530333"	"Monroe Czechia S.R.O."	"12.999.01.001"	128	96	32
"530338"	"BWO"	"12.999.01.001"	198	24	174
"530338"	"BWO"	"12.999.01.003"	6	0	6
"530356"	"Autohaus Widmann"	"12.999.01.001"	0	0	0
"530356"	"Autohaus Widmann"	"12.999.01.003"	0	0	0
"530478"	"HTD-Trailers GmbH"	"12.999.01.001"	0	0	0
"530478"	"HTD-Trailers GmbH"	"12.999.01.003"	0	0	0
"530478"	"HTD-Trailers GmbH"	"12.999.01.008"	0	0	0
"530478"	"HTD-Trailers GmbH"	"12.999.01.162"	0	0	0
"530478"	"HTD-Trailers GmbH"	"12.999.01.163"	0	0	0
"530536"	"MAT Commercial Vehicle"	"12.999.01.001"	1	11	-10
"530536"	"MAT Commercial Vehicle"	"12.999.01.003"	20	20	0
"530536"	"MAT Commercial Vehicle"	"12.999.01.008"	46	56	-10
"530621"	"Schenker (D) AG - Zebel (H)"	"12.999.01.008"	0	0	0
"530652"	"Waeles Nederland BV"	"12.999.01.001"	-19	0	-19
"530655"	"Walter Denoth"	"12.999.01.001"	0	0	0
"530761"	"Matthias Kühl"	"12.999.01.001"	1	0	1
"530761"	"Matthias Kühl"	"12.999.01.003"	1	0	1
"530813"	"Sievering"	"12.999.01.001"	2	0	2
"530901"	"Kammerer-Reifen GmbH"	"12.999.01.001"	1	0	1
"530901"	"Kammerer-Reifen GmbH"	"12.999.01.003"	1	0	1
"530908"	"HIL GmbH StPkt Oberviechtach"	"12.999.01.001"	0	0	0
"530946"	"AL-KO Record S.A."	"12.999.01.001"	60	0	60
"530959"	"Hofgut Elbaue"	"12.999.01.001"	1	0	1
"530959"	"Hofgut Elbaue"	"12.999.01.003"	6	0	6
"530959"	"Hofgut Elbaue"	"12.999.01.008"	5	0	5
"530964"	"Peter's Transporte u. Montagen GmbH"	"12.999.01.001"	1	0	1
"530964"	"Peter's Transporte u. Montagen GmbH"	"12.999.01.003"	5	0	5
"530984"	"Weigelt"	"12.999.01.001"	2	1	1
"530984"	"Weigelt"	"12.999.01.003"	1	1	0
"531030"	"Bandis & Knopp GmbH & Co. KG"	"12.999.01.003"	-28	0	-28
"531047"	"BASE VIE LGV GUINTOLI"	"12.999.01.003"	0	0	0
"531095"	"Agrargenossenschaft "Moorgrund" e.G"	"12.999.01.003"	0	0	0
"531150"	"KTH Trailer GmbH"	"12.999.01.003"	0	1	-1
"531239"	"HKM Fahrzeugbau GmbH i. I."	"12.999.01.001"	3	0	3
"531239"	"HKM Fahrzeugbau GmbH i. I."	"12.999.01.003"	4	0	4
"531247"	"WIHAG Fahrzeugsysteme GmbH"	"12.999.01.003"	2	0	2
"90000106"	"Saint-Gobain Performance"	"12.999.01.003"	0	0	0
"90000187"	"FRAMUER-HALBACH GMBH"	"12.999.01.001"	-1	0	-1
"90000276"	"FORGING PRODUCTS TRADING"	"12.999.01.003"	0	0	0
"90000337"	"Leist Oberflächentechnik e.K."	"12.999.01.003"	0	0	0
"90000337"	"Leist Oberflächentechnik e.K."	"12.999.01.008"	0	0	0
"90000388"	"DOLEZYCH GMBH & CO. KG"	"12.999.01.001"	-2	0	-2
"90000549"	"INTRA Logistik- und"	"12.999.01.003"	0	1	-1
