"Kunden Nr."	"Kunde"	"Material Nr."	Anfangsbestand	Retourniert	Zu berechnen
"100001"	"BPW-Fahrzeugtechnik"	"12.999.01.001"	-6	0	-6
"100001"	"BPW-Fahrzeugtechnik"	"12.999.01.003"	20	0	20
"100001"	"BPW-Fahrzeugtechnik"	"12.999.01.008"	1	0	1
"100002"	"M. Busch GmbH & Co. KG"	"12.999.01.001"	-3	63	-66
"100002"	"M. Busch GmbH & Co. KG"	"12.999.01.003"	-10	1	-11
"100002"	"M. Busch GmbH & Co. KG"	"12.999.01.008"	-7	30	-37
"100003"	"F. HESTERBERG & SOEHNE"	"12.999.01.001"	0	18	-18
"100010"	"BPW ITALIA S.R.L."	"12.999.01.001"	214	88	126
"100010"	"BPW ITALIA S.R.L."	"12.999.01.003"	1	177	-176
"100010"	"BPW ITALIA S.R.L."	"12.999.01.008"	-176	2	-178
"100010"	"BPW ITALIA S.R.L."	"12.999.01.188"	367	172	195
"100012"	"BPW LIMITED"	"12.999.01.001"	3	968	-965
"100012"	"BPW LIMITED"	"12.999.01.003"	587	249	338
"100012"	"BPW LIMITED"	"12.999.01.008"	115	132	-17
"100012"	"BPW LIMITED"	"12.999.01.162"	1	3648	-3647
"100012"	"BPW LIMITED"	"12.999.01.163"	263	696	-433
"100012"	"BPW LIMITED"	"12.999.01.188"	2	223	-221
"100013"	"BPW ITALIA S.R.L."	"12.999.01.001"	0	0	0
"100013"	"BPW ITALIA S.R.L."	"12.999.01.003"	0	24	-24
"100014"	"BPW EJES ESPAÑA, S.A."	"12.999.01.188"	6	0	6
"100015"	"FOMA"	"12.999.01.001"	2	1	1
"100015"	"FOMA"	"12.999.01.003"	435	65	370
"100016"	"BPW KRAATZ OY"	"12.999.01.003"	729	99	630
"100016"	"BPW KRAATZ OY"	"12.999.01.008"	5	0	5
"100016"	"BPW KRAATZ OY"	"12.999.01.188"	98	19	79
"100018"	"TRANSPORT-TEKNIK A/S"	"12.999.01.003"	235	40	195
"100020"	"FAHRZEUGBEDARF AG"	"12.999.01.001"	1	0	1
"100020"	"FAHRZEUGBEDARF AG"	"12.999.01.003"	17	0	17
"100020"	"FAHRZEUGBEDARF AG"	"12.999.01.008"	5	0	5
"100021"	"BPW Hofstad A/S"	"12.999.01.003"	2	2	0
"100021"	"BPW Hofstad A/S"	"12.999.01.008"	2	2	0
"100023"	"BPW Polska Sp. z o.o."	"12.999.01.001"	6	6	0
"100023"	"BPW Polska Sp. z o.o."	"12.999.01.003"	29	19	10
"100023"	"BPW Polska Sp. z o.o."	"12.999.01.188"	12	11	1
"100024"	"BPW spol. s.r.o."	"12.999.01.001"	0	0	0
"100024"	"BPW spol. s.r.o."	"12.999.01.003"	2	2	0
"100025"	"BPW-HUNGARIA KFT."	"12.999.01.001"	3	2750	-2747
"100025"	"BPW-HUNGARIA KFT."	"12.999.01.003"	-93	1540	-1633
"100025"	"BPW-HUNGARIA KFT."	"12.999.01.008"	1	2606	-2605
"100025"	"BPW-HUNGARIA KFT."	"12.999.01.011"	10	1	9
"100025"	"BPW-HUNGARIA KFT."	"12.999.01.162"	2	1436	-1434
"100025"	"BPW-HUNGARIA KFT."	"12.999.01.163"	265	347	-82
"100025"	"BPW-HUNGARIA KFT."	"12.999.01.188"	250	788	-538
"100029"	"HBN-TEKNIK A/S"	"12.999.01.001"	3	0	3
"100030"	"BPW TRAPACO S.L."	"12.999.01.003"	45	0	45
"100030"	"BPW TRAPACO S.L."	"12.999.01.008"	35	0	35
"100030"	"BPW TRAPACO S.L."	"12.999.01.162"	32	0	32
"100030"	"BPW TRAPACO S.L."	"12.999.01.163"	9	0	9
"100030"	"BPW TRAPACO S.L."	"12.999.01.188"	21	0	21
"100032"	"BPW FRANCE SAS"	"12.999.01.001"	42	22	20
"100032"	"BPW FRANCE SAS"	"12.999.01.003"	439	21	418
"100032"	"BPW FRANCE SAS"	"12.999.01.008"	0	9	-9
"100032"	"BPW FRANCE SAS"	"12.999.01.162"	0	2	-2
"100032"	"BPW FRANCE SAS"	"12.999.01.163"	2	0	2
"100032"	"BPW FRANCE SAS"	"12.999.01.188"	252	244	8
"100035"	"BPW Benelux sprl."	"12.999.01.001"	805	304	501
"100035"	"BPW Benelux sprl."	"12.999.01.003"	-244	156	-400
"100035"	"BPW Benelux sprl."	"12.999.01.008"	145	38	107
"100035"	"BPW Benelux sprl."	"12.999.01.162"	703	190	513
"100035"	"BPW Benelux sprl."	"12.999.01.163"	164	56	108
"100035"	"BPW Benelux sprl."	"12.999.01.165"	0	0	0
"100035"	"BPW Benelux sprl."	"12.999.01.188"	38	192	-154
"100036"	"Busch - Hungaria Kft."	"12.999.01.001"	117	1899	-1782
"100036"	"Busch - Hungaria Kft."	"12.999.01.003"	-115	0	-115
"100042"	""XL PARTS" SIA"	"12.999.01.003"	0	2	-2
"100043"	"Besko A/S"	"12.999.01.003"	137	9	128
"100048"	"Släpis AB"	"12.999.01.001"	8	0	8
"100048"	"Släpis AB"	"12.999.01.003"	107	31	76
"100049"	"Marpeto Polska Sp. z o.o."	"12.999.01.003"	1	3	-2
"210118"	"ASCHWEGE & TOENJES GMBH"	"12.999.01.001"	0	1	-1
"210118"	"ASCHWEGE & TOENJES GMBH"	"12.999.01.162"	6	6	0
"210118"	"ASCHWEGE & TOENJES GMBH"	"12.999.01.163"	2	2	0
"210118"	"ASCHWEGE & TOENJES GMBH"	"12.999.01.188"	0	0	0
"210234"	"LUDWIG BERGMANN GMBH"	"12.999.01.001"	0	1	-1
"210235"	"BRIRI GMBH"	"12.999.01.003"	0	1	-1
"210242"	"Bruns GmbH & Co. KG"	"12.999.01.001"	0	0	0
"210242"	"Bruns GmbH & Co. KG"	"12.999.01.003"	0	0	0
"210246"	"August Bruns"	"12.999.01.001"	0	0	0
"210247"	"Blomenröhr Fahrzeugbau GmbH"	"12.999.01.001"	7	2	5
"210247"	"Blomenröhr Fahrzeugbau GmbH"	"12.999.01.003"	25	1	24
"210305"	"Carnehl Fahrzeugbau"	"12.999.01.001"	56	25	31
"210305"	"Carnehl Fahrzeugbau"	"12.999.01.003"	-1	21	-22
"210305"	"Carnehl Fahrzeugbau"	"12.999.01.008"	12	8	4
"210305"	"Carnehl Fahrzeugbau"	"12.999.01.162"	40	4	36
"210305"	"Carnehl Fahrzeugbau"	"12.999.01.163"	10	1	9
"210305"	"Carnehl Fahrzeugbau"	"12.999.01.188"	26	1	25
"210507"	"EGGERS"	"12.999.01.001"	1	2	-1
"210507"	"EGGERS"	"12.999.01.003"	1	5	-4
"210602"	"FELDBINDER"	"12.999.01.001"	26	29	-3
"210602"	"FELDBINDER"	"12.999.01.003"	-2	8	-10
"210602"	"FELDBINDER"	"12.999.01.008"	4	7	-3
"210602"	"FELDBINDER"	"12.999.01.162"	40	40	0
"210602"	"FELDBINDER"	"12.999.01.163"	11	11	0
"210602"	"FELDBINDER"	"12.999.01.188"	77	72	5
"210613"	"WILHELM FRICKE GMBH"	"12.999.01.001"	9	9	0
"210613"	"WILHELM FRICKE GMBH"	"12.999.01.003"	0	1	-1
"210818"	"Hofmeister & Meincke GmbH & Co. KG"	"12.999.01.001"	17	14	3
"210818"	"Hofmeister & Meincke GmbH & Co. KG"	"12.999.01.003"	-64	4	-68
"210818"	"Hofmeister & Meincke GmbH & Co. KG"	"12.999.01.008"	1	1	0
"210833"	"A.-W. HEIL & SOHN GMBH & CO.KG"	"12.999.01.001"	1	1	0
"210845"	"HEINRICH HEUSER GMBH & CO. KG"	"12.999.01.001"	0	0	0
"210845"	"HEINRICH HEUSER GMBH & CO. KG"	"12.999.01.188"	0	0	0
"210849"	"HRD-TRAILER-ENGINEERING GMBH"	"12.999.01.001"	13	21	-8
"210849"	"HRD-TRAILER-ENGINEERING GMBH"	"12.999.01.003"	9	7	2
"210849"	"HRD-TRAILER-ENGINEERING GMBH"	"12.999.01.008"	8	13	-5
"210849"	"HRD-TRAILER-ENGINEERING GMBH"	"12.999.01.162"	18	16	2
"210849"	"HRD-TRAILER-ENGINEERING GMBH"	"12.999.01.163"	6	6	0
"210849"	"HRD-TRAILER-ENGINEERING GMBH"	"12.999.01.188"	7	7	0
"211108"	"Köhler Fahrzeugbau GmbH & Co.KG"	"12.999.01.001"	2	1	1
"211108"	"Köhler Fahrzeugbau GmbH & Co.KG"	"12.999.01.003"	1	0	1
"211108"	"Köhler Fahrzeugbau GmbH & Co.KG"	"12.999.01.188"	1	1	0
"211122"	"EMMY KLOOSS"	"12.999.01.001"	4	1	3
"211123"	"PETER KROEGER GMBH"	"12.999.01.001"	1	1	0
"211130"	"Josef Kotte"	"12.999.01.001"	0	0	0
"211130"	"Josef Kotte"	"12.999.01.003"	1	1	0
"211130"	"Josef Kotte"	"12.999.01.008"	0	0	0
"211130"	"Josef Kotte"	"12.999.01.188"	0	1	-1
"211133"	"KRUKENMEIER GMBH"	"12.999.01.001"	7	5	2
"211133"	"KRUKENMEIER GMBH"	"12.999.01.003"	2	2	0
"211133"	"KRUKENMEIER GMBH"	"12.999.01.008"	0	0	0
"211133"	"KRUKENMEIER GMBH"	"12.999.01.162"	4	4	0
"211133"	"KRUKENMEIER GMBH"	"12.999.01.163"	1	1	0
"211133"	"KRUKENMEIER GMBH"	"12.999.01.188"	6	0	6
"211134"	"KAR KUNZ"	"12.999.01.001"	-4	0	-4
"211134"	"KAR KUNZ"	"12.999.01.003"	2	1	1
"211136"	"Kedrowski Fahrzeugbau GmbH & Co. KG"	"12.999.01.001"	0	0	0
"211136"	"Kedrowski Fahrzeugbau GmbH & Co. KG"	"12.999.01.003"	0	0	0
"211325"	"MENKE-JANZEN"	"12.999.01.001"	30	9	21
"211325"	"MENKE-JANZEN"	"12.999.01.003"	-8	7	-15
"211325"	"MENKE-JANZEN"	"12.999.01.188"	0	1	-1
"211327"	"Moetefindt Fahrzeugbau"	"12.999.01.003"	0	2	-2
"211613"	"PV Automotive GmbH"	"12.999.01.001"	3	3	0
"211906"	"SPIER  GMBH & CO."	"12.999.01.001"	23	23	0
"211906"	"SPIER  GMBH & CO."	"12.999.01.003"	14	14	0
"211906"	"SPIER  GMBH & CO."	"12.999.01.008"	8	8	0
"211906"	"SPIER  GMBH & CO."	"12.999.01.162"	28	28	0
"211906"	"SPIER  GMBH & CO."	"12.999.01.163"	7	7	0
"211906"	"SPIER  GMBH & CO."	"12.999.01.188"	3	2	1
"211915"	"JUERGEN STERN"	"12.999.01.001"	1	0	1
"212004"	"SCHROEDER"	"12.999.01.001"	1	3	-2
"212004"	"SCHROEDER"	"12.999.01.003"	0	1	-1
"212004"	"SCHROEDER"	"12.999.01.188"	1	2	-1
"212010"	"SCHUETTE FAHRZEUGBAU GMBH"	"12.999.01.001"	1	1	0
"212010"	"SCHUETTE FAHRZEUGBAU GMBH"	"12.999.01.003"	1	1	0
"212012"	"KFB Jessen GmbH"	"12.999.01.001"	2	0	2
"212012"	"KFB Jessen GmbH"	"12.999.01.003"	2	0	2
"212019"	"W. SCHUETT GMBH"	"12.999.01.003"	0	1	-1
"212020"	"E. SCHWAGMEIER KAROSSERIE- UND"	"12.999.01.001"	-1	0	-1
"212020"	"E. SCHWAGMEIER KAROSSERIE- UND"	"12.999.01.003"	-2	0	-2
"212109"	"Stehmann GmbH"	"12.999.01.001"	2	4	-2
"212109"	"Stehmann GmbH"	"12.999.01.003"	3	4	-1
"212109"	"Stehmann GmbH"	"12.999.01.162"	0	0	0
"212109"	"Stehmann GmbH"	"12.999.01.163"	0	0	0
"212109"	"Stehmann GmbH"	"12.999.01.188"	1	0	1
"212110"	"METALLBAU STAGGENBORG GMBH"	"12.999.01.001"	-5	1	-6
"212110"	"METALLBAU STAGGENBORG GMBH"	"12.999.01.003"	2	0	2
"212209"	"HERMANN TECHAU"	"12.999.01.001"	1	1	0
"212213"	"TOS TWIST"	"12.999.01.188"	-1	0	-1
"212508"	"WABCO GmbH & Co. OHG"	"12.999.01.001"	-86	0	-86
"212527"	"Wiese GmbH & Co. KG"	"12.999.01.001"	6	0	6
"212527"	"Wiese GmbH & Co. KG"	"12.999.01.003"	4	0	4
"212527"	"Wiese GmbH & Co. KG"	"12.999.01.188"	4	0	4
"212528"	"WILKEN"	"12.999.01.001"	0	3	-3
"212528"	"WILKEN"	"12.999.01.003"	0	2	-2
"212528"	"WILKEN"	"12.999.01.188"	5	5	0
"212534"	"Heinrich Wellmeyer Fahrzeugbau"	"12.999.01.001"	0	5	-5
"212534"	"Heinrich Wellmeyer Fahrzeugbau"	"12.999.01.003"	1	1	0
"212534"	"Heinrich Wellmeyer Fahrzeugbau"	"12.999.01.188"	8	1	7
"212535"	"Weka Fahrzeugbau GmbH"	"12.999.01.001"	38	5	33
"212535"	"Weka Fahrzeugbau GmbH"	"12.999.01.003"	8	1	7
"212535"	"Weka Fahrzeugbau GmbH"	"12.999.01.008"	6	0	6
"212535"	"Weka Fahrzeugbau GmbH"	"12.999.01.162"	4	0	4
"212535"	"Weka Fahrzeugbau GmbH"	"12.999.01.163"	1	0	1
"212535"	"Weka Fahrzeugbau GmbH"	"12.999.01.188"	16	8	8
"212536"	"Wilhelm Wellmeyer Fahrzeugbau"	"12.999.01.001"	0	0	0
"212536"	"Wilhelm Wellmeyer Fahrzeugbau"	"12.999.01.003"	0	0	0
"220116"	"ATV-ELMER GMBH & CO. KG"	"12.999.01.001"	2	0	2
"220116"	"ATV-ELMER GMBH & CO. KG"	"12.999.01.003"	2	0	2
"220118"	"AMAZONEN-WERKE"	"12.999.01.001"	10	0	10
"220118"	"AMAZONEN-WERKE"	"12.999.01.003"	3	0	3
"220118"	"AMAZONEN-WERKE"	"12.999.01.008"	3	0	3
"220205"	"Bierhake Fahrzeugteile"	"12.999.01.001"	5	5	0
"220210"	"BOECKER Maschinenwerke GmbH"	"12.999.01.001"	2	2	0
"220228"	"Bohnenkamp AG"	"12.999.01.001"	4	1	3
"220252"	"PAUL BRUESER GMBH"	"12.999.01.001"	0	65	-65
"220252"	"PAUL BRUESER GMBH"	"12.999.01.003"	15	139	-124
"220252"	"PAUL BRUESER GMBH"	"12.999.01.008"	511	404	107
"220252"	"PAUL BRUESER GMBH"	"12.999.01.011"	3	0	3
"220254"	"BWO BEHINDERTEN-WERKSTAETTEN"	"12.999.01.001"	-13	78	-91
"220254"	"BWO BEHINDERTEN-WERKSTAETTEN"	"12.999.01.003"	147	93	54
"220254"	"BWO BEHINDERTEN-WERKSTAETTEN"	"12.999.01.008"	206	351	-145
"220255"	"BWO BEHINDERTEN-WERSTAETTEN"	"12.999.01.001"	-76	21	-97
"220255"	"BWO BEHINDERTEN-WERSTAETTEN"	"12.999.01.003"	-30	27	-57
"220255"	"BWO BEHINDERTEN-WERSTAETTEN"	"12.999.01.008"	61	75	-14
"220312"	"MANNSTAEDT GMBH & CO. KG"	"12.999.01.001"	1	12	-11
"220312"	"MANNSTAEDT GMBH & CO. KG"	"12.999.01.003"	2	1	1
"220414"	"FAHRZEUGBAU DRUMANN GMBH"	"12.999.01.001"	1	1	0
"220414"	"FAHRZEUGBAU DRUMANN GMBH"	"12.999.01.003"	1	1	0
"220523"	"EUROPART  Trading GmbH"	"12.999.01.003"	0	1	-1
"220605"	"EUROPART  Trading GMBH"	"12.999.01.001"	0	0	0
"220605"	"EUROPART  Trading GMBH"	"12.999.01.003"	0	1	-1
"220628"	"FONTANA GMBH"	"12.999.01.003"	-316	66	-382
"220628"	"FONTANA GMBH"	"12.999.01.008"	572	660	-88
"220629"	"GEORG FISCHER GMBH & CO. KG"	"12.999.01.001"	2	12	-10
"220629"	"GEORG FISCHER GMBH & CO. KG"	"12.999.01.003"	2	30	-28
"220703"	"GOFA Gocher Fahrzeugbau GmbH"	"12.999.01.001"	18	7	11
"220703"	"GOFA Gocher Fahrzeugbau GmbH"	"12.999.01.003"	4	6	-2
"220703"	"GOFA Gocher Fahrzeugbau GmbH"	"12.999.01.008"	0	1	-1
"220703"	"GOFA Gocher Fahrzeugbau GmbH"	"12.999.01.162"	4	0	4
"220703"	"GOFA Gocher Fahrzeugbau GmbH"	"12.999.01.188"	12	6	6
"220709"	"GEUEKE GMBH"	"12.999.01.001"	0	0	0
"220723"	"GKN SINTER METALS GMBH"	"12.999.01.003"	0	4	-4
"220814"	"Beilharz Nutzfahrzeuge"	"12.999.01.001"	2	0	2
"220814"	"Beilharz Nutzfahrzeuge"	"12.999.01.003"	1	0	1
"220838"	"HEIKO GMBH"	"12.999.01.003"	0	4	-4
"220843"	"HEETMANN & FINKENSIEP"	"12.999.01.003"	0	110	-110
"220843"	"HEETMANN & FINKENSIEP"	"12.999.01.008"	177	382	-205
"221113"	"Fahrzeugwerk Bernard Krone GmbH"	"12.999.01.001"	856	655	201
"221113"	"Fahrzeugwerk Bernard Krone GmbH"	"12.999.01.003"	164	91	73
"221113"	"Fahrzeugwerk Bernard Krone GmbH"	"12.999.01.008"	51	62	-11
"221113"	"Fahrzeugwerk Bernard Krone GmbH"	"12.999.01.162"	202	376	-174
"221113"	"Fahrzeugwerk Bernard Krone GmbH"	"12.999.01.163"	56	100	-44
"221113"	"Fahrzeugwerk Bernard Krone GmbH"	"12.999.01.188"	248	1121	-873
"221114"	"KLAESER INTERN. FACHSPEDITION"	"12.999.01.001"	1	1	0
"221114"	"KLAESER INTERN. FACHSPEDITION"	"12.999.01.003"	3	2	1
"221126"	"Kroll Fahrzeugbau-"	"12.999.01.001"	0	1	-1
"221126"	"Kroll Fahrzeugbau-"	"12.999.01.003"	0	1	-1
"221126"	"Kroll Fahrzeugbau-"	"12.999.01.188"	1	1	0
"221147"	"Krause GmbH"	"12.999.01.001"	0	2	-2
"221155"	"KRAMPE"	"12.999.01.001"	0	0	0
"221155"	"KRAMPE"	"12.999.01.003"	0	0	0
"221207"	"LEVEN NUTZFAHRZEUGE"	"12.999.01.001"	3	4	-1
"221207"	"LEVEN NUTZFAHRZEUGE"	"12.999.01.003"	2	0	2
"221213"	"Hermann Langfeld e.K."	"12.999.01.001"	5	3	2
"221213"	"Hermann Langfeld e.K."	"12.999.01.003"	2	1	1
"221213"	"Hermann Langfeld e.K."	"12.999.01.008"	0	0	0
"221213"	"Hermann Langfeld e.K."	"12.999.01.188"	4	2	2
"221214"	"LOECHTERFELD GMBH"	"12.999.01.001"	14	18	-4
"221214"	"LOECHTERFELD GMBH"	"12.999.01.003"	3	5	-2
"221221"	"LANCIER CABLE GMBH"	"12.999.01.001"	2	0	2
"221229"	"LEMKEN GMBH & CO. KG"	"12.999.01.001"	1	0	1
"221229"	"LEMKEN GMBH & CO. KG"	"12.999.01.008"	5	0	5
"221233"	"LANGENDORF GmbH"	"12.999.01.001"	156	85	71
"221233"	"LANGENDORF GmbH"	"12.999.01.003"	15	10	5
"221233"	"LANGENDORF GmbH"	"12.999.01.008"	25	34	-9
"221233"	"LANGENDORF GmbH"	"12.999.01.162"	-8	12	-20
"221233"	"LANGENDORF GmbH"	"12.999.01.163"	1	4	-3
"221233"	"LANGENDORF GmbH"	"12.999.01.188"	21	13	8
"221309"	"ANHAENGER- U. FAHRZEUGBAU"	"12.999.01.001"	10	11	-1
"221309"	"ANHAENGER- U. FAHRZEUGBAU"	"12.999.01.008"	1	0	1
"221309"	"ANHAENGER- U. FAHRZEUGBAU"	"12.999.01.188"	9	9	0
"221326"	"Menke Agrar GmbH"	"12.999.01.001"	0	0	0
"221404"	"NTV NUTZFAHRZEUGTEILE"	"12.999.01.001"	15	15	0
"221404"	"NTV NUTZFAHRZEUGTEILE"	"12.999.01.003"	5	5	0
"221506"	"OSTERATH GMBH"	"12.999.01.003"	1	0	1
"221506"	"OSTERATH GMBH"	"12.999.01.188"	2	0	2
"221609"	"PV Automotive GmbH"	"12.999.01.001"	0	0	0
"221609"	"PV Automotive GmbH"	"12.999.01.003"	0	0	0
"221610"	"PV Automotive GmbH"	"12.999.01.001"	29	15	14
"221610"	"PV Automotive GmbH"	"12.999.01.003"	32	3	29
"221610"	"PV Automotive GmbH"	"12.999.01.008"	1	0	1
"221613"	"PV Automotive GmbH"	"12.999.01.003"	1	1	0
"221813"	"GEBR. RECKER GMBH"	"12.999.01.001"	2	0	2
"221813"	"GEBR. RECKER GMBH"	"12.999.01.162"	4	4	0
"221813"	"GEBR. RECKER GMBH"	"12.999.01.163"	1	1	0
"221815"	"RI-FA"	"12.999.01.001"	0	5	-5
"221815"	"RI-FA"	"12.999.01.003"	0	0	0
"221907"	"SUER NUTZFAHRZEUGTECHNIK Gmbh & Co"	"12.999.01.001"	3	1	2
"222002"	"August Schmidt GmbH & Co. KG"	"12.999.01.001"	7	10	-3
"222002"	"August Schmidt GmbH & Co. KG"	"12.999.01.003"	2	2	0
"222002"	"August Schmidt GmbH & Co. KG"	"12.999.01.188"	8	8	0
"222016"	"FORTUNA FAHRZEUGBAU GMBH & CO. KG"	"12.999.01.003"	0	1	-1
"222016"	"FORTUNA FAHRZEUGBAU GMBH & CO. KG"	"12.999.01.008"	0	0	0
"222018"	"WALTER SCHORK GMBH"	"12.999.01.001"	0	1	-1
"222019"	"SCHMIDT KRAFTFAHRZEUG-"	"12.999.01.001"	5	8	-3
"222019"	"SCHMIDT KRAFTFAHRZEUG-"	"12.999.01.003"	0	2	-2
"222030"	"SCHMITZ-CARGOBULL AG"	"12.999.01.001"	2	0	2
"222030"	"SCHMITZ-CARGOBULL AG"	"12.999.01.003"	-17	0	-17
"222030"	"SCHMITZ-CARGOBULL AG"	"12.999.01.162"	0	0	0
"222030"	"SCHMITZ-CARGOBULL AG"	"12.999.01.163"	0	0	0
"222030"	"SCHMITZ-CARGOBULL AG"	"12.999.01.188"	0	0	0
"222032"	"SCHMITZ-CARGOBULL AG"	"12.999.01.001"	-19	11	-30
"222032"	"SCHMITZ-CARGOBULL AG"	"12.999.01.003"	-5	1	-6
"222032"	"SCHMITZ-CARGOBULL AG"	"12.999.01.008"	1	0	1
"222032"	"SCHMITZ-CARGOBULL AG"	"12.999.01.162"	0	56	-56
"222032"	"SCHMITZ-CARGOBULL AG"	"12.999.01.163"	0	14	-14
"222032"	"SCHMITZ-CARGOBULL AG"	"12.999.01.188"	26	50	-24
"222037"	"SCHRADER-T + A + Fahrzeugbau"	"12.999.01.001"	14	8	6
"222037"	"SCHRADER-T + A + Fahrzeugbau"	"12.999.01.003"	0	0	0
"222037"	"SCHRADER-T + A + Fahrzeugbau"	"12.999.01.008"	3	1	2
"222037"	"SCHRADER-T + A + Fahrzeugbau"	"12.999.01.188"	17	12	5
"222040"	"CARGOBULL"	"12.999.01.001"	0	17	-17
"222040"	"CARGOBULL"	"12.999.01.003"	0	1	-1
"222042"	"SCHMIEDAG GMBH"	"12.999.01.001"	24	0	24
"222204"	"GEBR. TITGEMEYER GMBH & CO. KG"	"12.999.01.003"	2	2	0
"222216"	"Albert Tebbe GmbH"	"12.999.01.001"	3	2	1
"222216"	"Albert Tebbe GmbH"	"12.999.01.003"	2	1	1
"222540"	"WINKLER FAHRZEUGTEILE GMBH"	"12.999.01.001"	1	1	0
"222543"	"WECON"	"12.999.01.001"	19	9	10
"222543"	"WECON"	"12.999.01.003"	17	17	0
"222543"	"WECON"	"12.999.01.008"	3	3	0
"222543"	"WECON"	"12.999.01.162"	2	0	2
"222543"	"WECON"	"12.999.01.163"	0	0	0
"222543"	"WECON"	"12.999.01.165"	2	0	2
"222543"	"WECON"	"12.999.01.188"	6	5	1
"222547"	"W+O NIETTECHNIK GMBH"	"12.999.01.001"	1	0	1
"222547"	"W+O NIETTECHNIK GMBH"	"12.999.01.003"	101	0	101
"222547"	"W+O NIETTECHNIK GMBH"	"12.999.01.008"	310	0	310
"223001"	"SCHOMAECKER FEDERNWERK GMBH"	"12.999.01.001"	71	0	71
"223001"	"SCHOMAECKER FEDERNWERK GMBH"	"12.999.01.003"	-436	8	-444
"223007"	"FEDERAL MOGUL"	"12.999.01.001"	0	10	-10
"223007"	"FEDERAL MOGUL"	"12.999.01.003"	0	20	-20
"223007"	"FEDERAL MOGUL"	"12.999.01.008"	0	51	-51
"223008"	"Rütgers GmbH & Co. KG"	"12.999.01.001"	2	0	2
"223008"	"Rütgers GmbH & Co. KG"	"12.999.01.003"	12	0	12
"223017"	"WESTFALEN AG"	"12.999.01.003"	1	1	0
"230000"	"BPW Bergische Achsen"	"12.999.01.001"	17	277	-260
"230000"	"BPW Bergische Achsen"	"12.999.01.003"	36	81	-45
"230000"	"BPW Bergische Achsen"	"12.999.01.008"	3	2	1
"240240"	"Benninghoven GmbH & Co KG"	"12.999.01.003"	5	0	5
"240418"	"DUENSCHEDE FAHRZEUGBAU"	"12.999.01.188"	0	0	0
"240505"	"DR. ING. ULRICH ESTERER GMBH & CO."	"12.999.01.001"	1	0	1
"240505"	"DR. ING. ULRICH ESTERER GMBH & CO."	"12.999.01.003"	18	0	18
"240518"	"EUROPART"	"12.999.01.001"	1	0	1
"240519"	"EWERS KAROSSERIE- UND"	"12.999.01.003"	0	1	-1
"240520"	"EUROPART  Trading GMBH"	"12.999.01.001"	1	0	1
"240522"	"EISEL NUTZFAHRZEUGE GMBH"	"12.999.01.001"	0	2	-2
"240522"	"EISEL NUTZFAHRZEUGE GMBH"	"12.999.01.188"	0	2	-2
"240733"	"GANGOLF NUTZFAHRZEUGE GMBH"	"12.999.01.001"	2	0	2
"240827"	"HEURICH"	"12.999.01.001"	1	0	1
"240827"	"HEURICH"	"12.999.01.003"	2	0	2
"241008"	"Jost  Werke GmbH"	"12.999.01.001"	-86	5	-91
"241008"	"Jost  Werke GmbH"	"12.999.01.003"	0	0	0
"241114"	"ERICH KERSTING GMBH & CO. KG"	"12.999.01.001"	3	3	0
"241114"	"ERICH KERSTING GMBH & CO. KG"	"12.999.01.003"	1	1	0
"241134"	"Fahrzeugbau Kempf GmbH"	"12.999.01.001"	123	130	-7
"241134"	"Fahrzeugbau Kempf GmbH"	"12.999.01.003"	0	11	-11
"241134"	"Fahrzeugbau Kempf GmbH"	"12.999.01.008"	2	4	-2
"241134"	"Fahrzeugbau Kempf GmbH"	"12.999.01.162"	0	0	0
"241134"	"Fahrzeugbau Kempf GmbH"	"12.999.01.163"	0	0	0
"241134"	"Fahrzeugbau Kempf GmbH"	"12.999.01.188"	118	103	15
"241146"	"KEMPF FAHRZEUGBAU"	"12.999.01.001"	4	0	4
"241146"	"KEMPF FAHRZEUGBAU"	"12.999.01.188"	7	0	7
"241214"	"LUECK FAHRZEUGBAU GMBH"	"12.999.01.001"	2	1	1
"241214"	"LUECK FAHRZEUGBAU GMBH"	"12.999.01.003"	1	1	0
"241214"	"LUECK FAHRZEUGBAU GMBH"	"12.999.01.188"	2	0	2
"241216"	"LEISE GMBH & CO. KG"	"12.999.01.001"	1	4	-3
"241216"	"LEISE GMBH & CO. KG"	"12.999.01.003"	0	0	0
"241217"	"KRAMP Groep B.V."	"12.999.01.001"	7	7	0
"241220"	"Link Fahrzeugbau GmbH"	"12.999.01.001"	0	1	-1
"241220"	"Link Fahrzeugbau GmbH"	"12.999.01.003"	0	1	-1
"241325"	"WM SE"	"12.999.01.001"	0	0	0
"241328"	"A. MUELLER FAHRZEUGBAU GMBH"	"12.999.01.001"	3	1	2
"241328"	"A. MUELLER FAHRZEUGBAU GMBH"	"12.999.01.188"	2	1	1
"241349"	"F. MUELLER GMBH & CO. KG"	"12.999.01.001"	2	2	0
"241349"	"F. MUELLER GMBH & CO. KG"	"12.999.01.003"	1	1	0
"241349"	"F. MUELLER GMBH & CO. KG"	"12.999.01.188"	1	1	0
"241350"	"MENZER GMBH"	"12.999.01.001"	1	0	1
"241505"	"ORTEN GMBH & CO. KG"	"12.999.01.003"	1	1	0
"241618"	"PROFI PARTS"	"12.999.01.001"	99	6	93
"241618"	"PROFI PARTS"	"12.999.01.003"	-8	0	-8
"241619"	"PROFI PARTS"	"12.999.01.001"	13	4	9
"241619"	"PROFI PARTS"	"12.999.01.003"	5	0	5
"241620"	"PROFI PARTS"	"12.999.01.001"	2	2	0
"241841"	"Winkler Logistik GmbH"	"12.999.01.001"	2	21	-19
"241841"	"Winkler Logistik GmbH"	"12.999.01.003"	2	8	-6
"242506"	"EUROPART  Trading GMBH"	"12.999.01.001"	1	0	1
"242516"	"WELLER GMBH & CO. KG"	"12.999.01.001"	0	1	-1
"242516"	"WELLER GMBH & CO. KG"	"12.999.01.003"	0	1	-1
"242516"	"WELLER GMBH & CO. KG"	"12.999.01.008"	2	2	0
"242520"	"HEINRICH WEDEKIND &"	"12.999.01.001"	2	7	-5
"242520"	"HEINRICH WEDEKIND &"	"12.999.01.003"	1	2	-1
"242524"	"Wütschner"	"12.999.01.001"	0	1	-1
"250212"	"BIRNER GMBH"	"12.999.01.001"	1	3	-2
"250213"	"BISCHOFF + SCHECK AG"	"12.999.01.003"	0	0	0
"250409"	"DIER & JAKOB"	"12.999.01.001"	3	0	3
"250503"	"EICHKORN FAHRZEUGBAU"	"12.999.01.001"	0	0	0
"250611"	"FGS GMBH"	"12.999.01.001"	6	1	5
"250807"	"HONOLD GMBH & CO.KG"	"12.999.01.001"	0	0	0
"250807"	"HONOLD GMBH & CO.KG"	"12.999.01.003"	0	0	0
"250807"	"HONOLD GMBH & CO.KG"	"12.999.01.188"	2	0	2
"250822"	"HIRTH FAHRZEUGBAU GMBH"	"12.999.01.001"	1	0	1
"251113"	"KAROSSERIEFABRIK BIBERACH GMBH"	"12.999.01.001"	0	0	0
"251113"	"KAROSSERIEFABRIK BIBERACH GMBH"	"12.999.01.003"	0	0	0
"251113"	"KAROSSERIEFABRIK BIBERACH GMBH"	"12.999.01.188"	0	0	0
"251121"	"MASCHINENBAU KALTENBACH GMBH"	"12.999.01.001"	2	2	0
"251121"	"MASCHINENBAU KALTENBACH GMBH"	"12.999.01.003"	1	1	0
"251121"	"MASCHINENBAU KALTENBACH GMBH"	"12.999.01.188"	1	1	0
"251132"	"KAMAG"	"12.999.01.001"	1	1	0
"251132"	"KAMAG"	"12.999.01.003"	1	1	0
"251203"	"LIEBHERR-WERK"	"12.999.01.001"	4	1	3
"251203"	"LIEBHERR-WERK"	"12.999.01.003"	12	3	9
"251203"	"LIEBHERR-WERK"	"12.999.01.008"	1	0	1
"251208"	"L + M FAHRZEUGBAU GMBH"	"12.999.01.001"	1	1	0
"251208"	"L + M FAHRZEUGBAU GMBH"	"12.999.01.003"	2	3	-1
"251302"	"MUENZ FAHRZEUGBAU GMBH & CO.KG"	"12.999.01.001"	0	0	0
"251302"	"MUENZ FAHRZEUGBAU GMBH & CO.KG"	"12.999.01.003"	0	0	0
"251306"	"Karl Mueller GmbH & Co. KG"	"12.999.01.001"	8	8	0
"251306"	"Karl Mueller GmbH & Co. KG"	"12.999.01.003"	44	61	-17
"251306"	"Karl Mueller GmbH & Co. KG"	"12.999.01.008"	0	0	0
"251306"	"Karl Mueller GmbH & Co. KG"	"12.999.01.162"	0	8	-8
"251306"	"Karl Mueller GmbH & Co. KG"	"12.999.01.163"	0	0	0
"251306"	"Karl Mueller GmbH & Co. KG"	"12.999.01.188"	0	0	0
"251317"	"MS-PARTS GMBH"	"12.999.01.001"	1	5	-4
"251317"	"MS-PARTS GMBH"	"12.999.01.003"	4	6	-2
"251317"	"MS-PARTS GMBH"	"12.999.01.188"	0	3	-3
"251405"	"Neumayer Tekfor GmbH"	"12.999.01.001"	19	74	-55
"251405"	"Neumayer Tekfor GmbH"	"12.999.01.003"	58	140	-82
"251405"	"Neumayer Tekfor GmbH"	"12.999.01.008"	268	500	-232
"251805"	"Winkler Logistik GmbH"	"12.999.01.001"	14	0	14
"251812"	"Winkler Logistik GmbH"	"12.999.01.001"	245	69	176
"251812"	"Winkler Logistik GmbH"	"12.999.01.003"	20	53	-33
"251812"	"Winkler Logistik GmbH"	"12.999.01.008"	1	0	1
"251904"	"SPITZER"	"12.999.01.001"	5	7	-2
"251904"	"SPITZER"	"12.999.01.003"	7	4	3
"251904"	"SPITZER"	"12.999.01.008"	0	0	0
"251904"	"SPITZER"	"12.999.01.188"	46	19	27
"252018"	"SCHEUERLE"	"12.999.01.001"	2	2	0
"252018"	"SCHEUERLE"	"12.999.01.003"	11	10	1
"252020"	"SCHAEFER-TECHNIC GMBH"	"12.999.01.001"	1	1	0
"252020"	"SCHAEFER-TECHNIC GMBH"	"12.999.01.003"	1	1	0
"252029"	"AEBI SCHMIDT DEUTSCHLAND GMBH"	"12.999.01.001"	14	0	14
"252029"	"AEBI SCHMIDT DEUTSCHLAND GMBH"	"12.999.01.003"	43	2	41
"252029"	"AEBI SCHMIDT DEUTSCHLAND GMBH"	"12.999.01.008"	1	0	1
"252107"	"STAIGER NUTZFAHRZEUGE GMBH"	"12.999.01.001"	1	0	1
"252110"	"AUTOTEILE STREB GMBH"	"12.999.01.003"	-1	0	-1
"252204"	"TROST AUTO SERVICE TECHNIK SE"	"12.999.01.001"	1	0	1
"252509"	"WINKLER Fahrzeugteile GmbH & Co.KG"	"12.999.01.001"	2	5	-3
"252509"	"WINKLER Fahrzeugteile GmbH & Co.KG"	"12.999.01.003"	0	1	-1
"252517"	"HANS-PETER WOLF"	"12.999.01.001"	0	0	0
"252522"	"J. WILLIBALD"	"12.999.01.001"	1	0	1
"252522"	"J. WILLIBALD"	"12.999.01.003"	1	0	1
"252522"	"J. WILLIBALD"	"12.999.01.008"	1	0	1
"252702"	"ZIKUN FAHRZEUGBAU GMBH"	"12.999.01.001"	6	3	3
"252702"	"ZIKUN FAHRZEUGBAU GMBH"	"12.999.01.003"	2	0	2
"252702"	"ZIKUN FAHRZEUGBAU GMBH"	"12.999.01.188"	9	8	1
"252704"	"GUSTAV ZIEGLER GMBH"	"12.999.01.001"	1	1	0
"252704"	"GUSTAV ZIEGLER GMBH"	"12.999.01.003"	1	1	0
"253032"	"KLUMPP & MUELLER GMBH & CO. KG"	"12.999.01.001"	1	0	1
"253032"	"KLUMPP & MUELLER GMBH & CO. KG"	"12.999.01.003"	1	0	1
"260216"	"BNT GMBH"	"12.999.01.001"	1	3	-2
"260218"	"Lely Agrartechnik GmbH"	"12.999.01.001"	0	0	0
"260218"	"Lely Agrartechnik GmbH"	"12.999.01.008"	0	0	0
"260405"	"JOHANN DEMMLER KG"	"12.999.01.001"	6	6	0
"260405"	"JOHANN DEMMLER KG"	"12.999.01.003"	18	11	7
"260405"	"JOHANN DEMMLER KG"	"12.999.01.008"	1	1	0
"260502"	"ECKART Maschinenbau GmbH"	"12.999.01.001"	1	1	0
"260514"	"EUROPART  Trading GMBH"	"12.999.01.003"	0	1	-1
"260604"	"JOSEF FINKL KG"	"12.999.01.001"	1	2	-1
"260604"	"JOSEF FINKL KG"	"12.999.01.003"	0	1	-1
"260604"	"JOSEF FINKL KG"	"12.999.01.162"	0	0	0
"260604"	"JOSEF FINKL KG"	"12.999.01.163"	0	0	0
"260604"	"JOSEF FINKL KG"	"12.999.01.188"	0	0	0
"260613"	"FLIEGL FAHRZEUGBAU GMBH"	"12.999.01.001"	221	34	187
"260613"	"FLIEGL FAHRZEUGBAU GMBH"	"12.999.01.003"	57	11	46
"260613"	"FLIEGL FAHRZEUGBAU GMBH"	"12.999.01.008"	31	8	23
"260613"	"FLIEGL FAHRZEUGBAU GMBH"	"12.999.01.162"	8	10	-2
"260613"	"FLIEGL FAHRZEUGBAU GMBH"	"12.999.01.163"	-3	3	-6
"260613"	"FLIEGL FAHRZEUGBAU GMBH"	"12.999.01.165"	6	0	6
"260613"	"FLIEGL FAHRZEUGBAU GMBH"	"12.999.01.188"	71	29	42
"260618"	"FLIEGL Agrartechnik GmbH"	"12.999.01.001"	6	5	1
"260618"	"FLIEGL Agrartechnik GmbH"	"12.999.01.003"	10	0	10
"260618"	"FLIEGL Agrartechnik GmbH"	"12.999.01.008"	12	0	12
"260618"	"FLIEGL Agrartechnik GmbH"	"12.999.01.162"	36	10	26
"260618"	"FLIEGL Agrartechnik GmbH"	"12.999.01.163"	17	3	14
"260618"	"FLIEGL Agrartechnik GmbH"	"12.999.01.188"	23	5	18
"260620"	"Fliegl Agro-Center GmbH"	"12.999.01.001"	0	1	-1
"260702"	"JOSEF GEIDOBLER & SOHN GMBH"	"12.999.01.001"	0	1	-1
"260702"	"JOSEF GEIDOBLER & SOHN GMBH"	"12.999.01.003"	0	2	-2
"260704"	"Goldhofer Aktiengesellschaft"	"12.999.01.001"	43	22	21
"260704"	"Goldhofer Aktiengesellschaft"	"12.999.01.003"	105	85	20
"260704"	"Goldhofer Aktiengesellschaft"	"12.999.01.008"	3	7	-4
"260704"	"Goldhofer Aktiengesellschaft"	"12.999.01.162"	38	22	16
"260704"	"Goldhofer Aktiengesellschaft"	"12.999.01.163"	11	7	4
"260704"	"Goldhofer Aktiengesellschaft"	"12.999.01.188"	0	0	0
"260714"	"GLOGGER FAHRZEUGBAU GMBH"	"12.999.01.001"	5	0	5
"260714"	"GLOGGER FAHRZEUGBAU GMBH"	"12.999.01.003"	20	0	20
"260803"	"HUTTNER"	"12.999.01.001"	1	2	-1
"260803"	"HUTTNER"	"12.999.01.003"	0	2	-2
"260808"	"Günther Hefele Großhandel für"	"12.999.01.001"	0	0	0
"260811"	"HUMBAUR GMBH"	"12.999.01.001"	20	12	8
"260811"	"HUMBAUR GMBH"	"12.999.01.003"	30	22	8
"260811"	"HUMBAUR GMBH"	"12.999.01.008"	15	4	11
"260813"	"HOFMANN"	"12.999.01.003"	1	1	0
"261115"	"KAFFL Fahrzeugbau GmbH"	"12.999.01.001"	0	2	-2
"261126"	"KOTSCHENREUTHER"	"12.999.01.001"	0	0	0
"261126"	"KOTSCHENREUTHER"	"12.999.01.008"	0	0	0
"261126"	"KOTSCHENREUTHER"	"12.999.01.162"	0	0	0
"261126"	"KOTSCHENREUTHER"	"12.999.01.163"	0	0	0
"261132"	"KUVVETLI FAHRZEUGBAU e.K."	"12.999.01.001"	0	1	-1
"261132"	"KUVVETLI FAHRZEUGBAU e.K."	"12.999.01.003"	0	1	-1
"261203"	"LINDNER & FISCHER"	"12.999.01.001"	3	3	0
"261203"	"LINDNER & FISCHER"	"12.999.01.003"	0	0	0
"261203"	"LINDNER & FISCHER"	"12.999.01.008"	1	1	0
"261203"	"LINDNER & FISCHER"	"12.999.01.188"	4	4	0
"261312"	"MEUSBURGER"	"12.999.01.001"	418	27	391
"261312"	"MEUSBURGER"	"12.999.01.003"	401	22	379
"261312"	"MEUSBURGER"	"12.999.01.008"	32	1	31
"261312"	"MEUSBURGER"	"12.999.01.162"	108	54	54
"261312"	"MEUSBURGER"	"12.999.01.163"	43	15	28
"261312"	"MEUSBURGER"	"12.999.01.188"	36	3	33
"261606"	"Paul Nutzfahrzeuge GmbH"	"12.999.01.001"	2	0	2
"261606"	"Paul Nutzfahrzeuge GmbH"	"12.999.01.003"	5	0	5
"261608"	"POPP FAHRZEUGBAU GMBH"	"12.999.01.001"	1	1	0
"261608"	"POPP FAHRZEUGBAU GMBH"	"12.999.01.003"	2	2	0
"261802"	"MARTIN REISCH GMBH"	"12.999.01.001"	3	3	0
"261802"	"MARTIN REISCH GMBH"	"12.999.01.003"	6	5	1
"261802"	"MARTIN REISCH GMBH"	"12.999.01.162"	6	2	4
"261802"	"MARTIN REISCH GMBH"	"12.999.01.163"	3	1	2
"261802"	"MARTIN REISCH GMBH"	"12.999.01.188"	15	2	13
"261809"	"MARTIN REISCH GMBH"	"12.999.01.001"	19	15	4
"261809"	"MARTIN REISCH GMBH"	"12.999.01.003"	2	1	1
"261809"	"MARTIN REISCH GMBH"	"12.999.01.188"	31	9	22
"261818"	"NUTZFAHRZEUGE ROHR GMBH"	"12.999.01.001"	21	13	8
"261818"	"NUTZFAHRZEUGE ROHR GMBH"	"12.999.01.003"	2	6	-4
"261818"	"NUTZFAHRZEUGE ROHR GMBH"	"12.999.01.188"	16	3	13
"261905"	"ZF SACHS AG"	"12.999.01.001"	-164	60	-224
"261905"	"ZF SACHS AG"	"12.999.01.003"	-5	0	-5
"262036"	"SCHMID FAHRZEUGBAU GMBH"	"12.999.01.001"	1	1	0
"262036"	"SCHMID FAHRZEUGBAU GMBH"	"12.999.01.003"	2	2	0
"262103"	"AUTOTEILE STREB"	"12.999.01.001"	0	2	-2
"262103"	"AUTOTEILE STREB"	"12.999.01.003"	0	1	-1
"262217"	"TROST AUTO SERVICE TECHNIK SE"	"12.999.01.001"	1	0	1
"262217"	"TROST AUTO SERVICE TECHNIK SE"	"12.999.01.003"	2	0	2
"262506"	"KURT WILLIG GMBH & CO. KG"	"12.999.01.001"	1	0	1
"262506"	"KURT WILLIG GMBH & CO. KG"	"12.999.01.003"	1	1	0
"262510"	"WAGNER-FAHRZEUGBAU GMBH"	"12.999.01.001"	0	0	0
"262510"	"WAGNER-FAHRZEUGBAU GMBH"	"12.999.01.188"	0	0	0
"262703"	"ZUNHAMMER GMBH"	"12.999.01.001"	9	0	9
"262703"	"ZUNHAMMER GMBH"	"12.999.01.003"	4	1	3
"262705"	"Zanner Fahrzeugbau GmbH"	"12.999.01.001"	5	0	5
"262706"	"ZEBU FAHRZEUGBAU GmbH & Co. KG"	"12.999.01.001"	1	1	0
"263015"	"BAYWA AG"	"12.999.01.001"	0	2	-2
"270104"	"ANNABURGER NUTZFAHRZEUG GMBH"	"12.999.01.001"	2	1	1
"270104"	"ANNABURGER NUTZFAHRZEUG GMBH"	"12.999.01.003"	2	2	0
"270119"	"ACKERMANN FAHRZEUGBAU"	"12.999.01.001"	41	29	12
"270119"	"ACKERMANN FAHRZEUGBAU"	"12.999.01.003"	31	24	7
"270119"	"ACKERMANN FAHRZEUGBAU"	"12.999.01.008"	0	1	-1
"270119"	"ACKERMANN FAHRZEUGBAU"	"12.999.01.188"	23	17	6
"270204"	"BEFA  BELZIGER-"	"12.999.01.001"	0	2	-2
"270217"	"BBG BODENBEARBEITUNGSGERAETE"	"12.999.01.001"	0	0	0
"270404"	"Kurt Dinkel"	"12.999.01.001"	21	2	19
"270404"	"Kurt Dinkel"	"12.999.01.003"	0	1	-1
"270404"	"Kurt Dinkel"	"12.999.01.188"	2	1	1
"270619"	"FERDINAND SCHULTZ NACHFOLGER"	"12.999.01.001"	0	0	0
"270619"	"FERDINAND SCHULTZ NACHFOLGER"	"12.999.01.003"	0	0	0
"270620"	"Feldbinder"	"12.999.01.001"	16	15	1
"270620"	"Feldbinder"	"12.999.01.003"	7	5	2
"270620"	"Feldbinder"	"12.999.01.008"	1	2	-1
"270620"	"Feldbinder"	"12.999.01.188"	18	31	-13
"270623"	"RICHARD FEUCHTEMEYER"	"12.999.01.001"	0	0	0
"270623"	"RICHARD FEUCHTEMEYER"	"12.999.01.003"	0	0	0
"270624"	"FAG"	"12.999.01.001"	0	2	-2
"270624"	"FAG"	"12.999.01.003"	-1	4	-5
"270624"	"FAG"	"12.999.01.188"	2	2	0
"270804"	"Hüffermann"	"12.999.01.001"	17	39	-22
"270804"	"Hüffermann"	"12.999.01.003"	5	22	-17
"270804"	"Hüffermann"	"12.999.01.008"	1	2	-1
"270804"	"Hüffermann"	"12.999.01.162"	59	62	-3
"270804"	"Hüffermann"	"12.999.01.163"	15	17	-2
"270804"	"Hüffermann"	"12.999.01.188"	21	24	-3
"270805"	"HERZ NUTZFAHRZEUGTEILE GMBH"	"12.999.01.001"	2	5	-3
"270810"	"HKM FAHRZEUGBAU GMBH"	"12.999.01.001"	2	0	2
"270810"	"HKM FAHRZEUGBAU GMBH"	"12.999.01.003"	1	1	0
"270815"	"HELLMERS GMBH"	"12.999.01.001"	1	1	0
"270815"	"HELLMERS GMBH"	"12.999.01.188"	1	1	0
"271102"	"FRANK & SOHN"	"12.999.01.001"	0	2	-2
"271112"	"KOTSCHENREUTHER FAHRZEUGBAU"	"12.999.01.001"	0	1	-1
"271112"	"KOTSCHENREUTHER FAHRZEUGBAU"	"12.999.01.003"	0	1	-1
"271114"	"Kirow Ardelt GmbH"	"12.999.01.003"	0	0	0
"271118"	"PLATAL MOBILSYSTEME GMBH"	"12.999.01.001"	0	0	0
"271118"	"PLATAL MOBILSYSTEME GMBH"	"12.999.01.003"	0	0	0
"271118"	"PLATAL MOBILSYSTEME GMBH"	"12.999.01.188"	0	0	0
"271307"	"FMS Fahrzeugbau GmbH"	"12.999.01.001"	11	3	8
"271307"	"FMS Fahrzeugbau GmbH"	"12.999.01.003"	-1	3	-4
"271307"	"FMS Fahrzeugbau GmbH"	"12.999.01.162"	0	4	-4
"271307"	"FMS Fahrzeugbau GmbH"	"12.999.01.163"	2	0	2
"271311"	"MAFA"	"12.999.01.001"	27	15	12
"271311"	"MAFA"	"12.999.01.008"	7	7	0
"271311"	"MAFA"	"12.999.01.163"	1	1	0
"271311"	"MAFA"	"12.999.01.188"	18	10	8
"271505"	"ORTEN GmbH & Co. KG"	"12.999.01.001"	1	1	0
"271505"	"ORTEN GmbH & Co. KG"	"12.999.01.003"	-1	1	-2
"271910"	"SAXAS"	"12.999.01.001"	0	2	-2
"271910"	"SAXAS"	"12.999.01.008"	1	1	0
"272010"	"SCHMITZ CARGOBULL"	"12.999.01.001"	0	0	0
"272010"	"SCHMITZ CARGOBULL"	"12.999.01.188"	0	0	0
"272017"	"Schmitz Cargobull"	"12.999.01.001"	4	4	0
"272017"	"Schmitz Cargobull"	"12.999.01.008"	0	0	0
"272017"	"Schmitz Cargobull"	"12.999.01.188"	2	2	0
"272502"	"Schlosser Europart"	"12.999.01.001"	2	0	2
"272502"	"Schlosser Europart"	"12.999.01.003"	2	0	2
"272502"	"Schlosser Europart"	"12.999.01.008"	1	0	1
"272505"	"WILLIG FAHRZEUGBAU GMBH"	"12.999.01.001"	3	3	0
"272505"	"WILLIG FAHRZEUGBAU GMBH"	"12.999.01.003"	3	3	0
"272505"	"WILLIG FAHRZEUGBAU GMBH"	"12.999.01.008"	1	1	0
"272505"	"WILLIG FAHRZEUGBAU GMBH"	"12.999.01.188"	9	8	1
"272506"	"WESSEL-FAHRZEUGTEILE GMBH"	"12.999.01.001"	5	7	-2
"272506"	"WESSEL-FAHRZEUGTEILE GMBH"	"12.999.01.003"	1	5	-4
"272516"	"EUROPART  Trading GMBH"	"12.999.01.008"	1	1	0
"280237"	"M. BUSCH GMBH & CO. KG"	"12.999.01.001"	40	0	40
"320006"	"OFFERGELD GMBH & CO."	"12.999.01.001"	1	0	1
"320017"	"HELLA KOCH GMBH"	"12.999.01.001"	0	0	0
"320037"	"Frye Transport-Logistik GMBH"	"12.999.01.001"	6	6	0
"320037"	"Frye Transport-Logistik GMBH"	"12.999.01.003"	-233	9	-242
"320080"	"GEORG KRAEMER FAHRZEUGBAU"	"12.999.01.003"	0	1	-1
"320102"	"NCG NUTZFAHRZEUG-CENTER GMBH"	"12.999.01.001"	1	1	0
"320132"	"KAMAX-WERKE"	"12.999.01.003"	58	396	-338
"320132"	"KAMAX-WERKE"	"12.999.01.008"	616	693	-77
"320147"	"JOHANNES REINERS"	"12.999.01.001"	1	0	1
"320150"	"Nagel-Group"	"12.999.01.001"	1	0	1
"320150"	"Nagel-Group"	"12.999.01.003"	2	0	2
"320217"	"Heinrich Stratmann GmbH"	"12.999.01.001"	0	0	0
"360108"	"ALNUFA"	"12.999.01.003"	0	1	-1
"360132"	"P. SCHWANDNER"	"12.999.01.001"	1	1	0
"370002"	"SCANRO GMBH"	"12.999.01.001"	0	2	-2
"370046"	"Elflein Spedition & Transport GmbH"	"12.999.01.001"	1	0	1
"370046"	"Elflein Spedition & Transport GmbH"	"12.999.01.003"	1	0	1
"370175"	"Manfred Manig"	"12.999.01.001"	1	0	1
"390502"	"WINCANTON TRANS EUROPEAN (D) GmbH"	"12.999.01.003"	-4	0	-4
"390503"	"WIELAND-WERKE AG"	"12.999.01.001"	30	0	30
"390503"	"WIELAND-WERKE AG"	"12.999.01.003"	-58	0	-58
"390510"	"TMD FRICTION GMBH"	"12.999.01.001"	-8	420	-428
"390510"	"TMD FRICTION GMBH"	"12.999.01.003"	209	1113	-904
"390510"	"TMD FRICTION GMBH"	"12.999.01.008"	711	804	-93
"390511"	"SONA BLW"	"12.999.01.001"	14	62	-48
"390511"	"SONA BLW"	"12.999.01.003"	-1	0	-1
"390513"	"THIEL & HOCHE GMBH & CO. KG"	"12.999.01.001"	19	30	-11
"390513"	"THIEL & HOCHE GMBH & CO. KG"	"12.999.01.003"	24	0	24
"390513"	"THIEL & HOCHE GMBH & CO. KG"	"12.999.01.008"	77	0	77
"390514"	"THH DREHTEILE GMBH"	"12.999.01.001"	3	0	3
"390514"	"THH DREHTEILE GMBH"	"12.999.01.003"	-3	0	-3
"390516"	"ERICH SYDOW GMBH & CO. KG"	"12.999.01.003"	-1	0	-1
"390519"	"SKF GmbH"	"12.999.01.003"	173	13	160
"390525"	"SCHIEFFER GMBH & CO. KG"	"12.999.01.001"	69	60	9
"390525"	"SCHIEFFER GMBH & CO. KG"	"12.999.01.003"	9	51	-42
"390525"	"SCHIEFFER GMBH & CO. KG"	"12.999.01.008"	166	190	-24
"390526"	"SCHENKER"	"12.999.01.001"	-13	60	-73
"390526"	"SCHENKER"	"12.999.01.003"	0	50	-50
"390528"	"ADOLF PUEHL GMBH & CO. KG"	"12.999.01.003"	-69	0	-69
"390530"	"PEINER UMFORMTECHNIK GMBH"	"12.999.01.003"	-28	499	-527
"390530"	"PEINER UMFORMTECHNIK GMBH"	"12.999.01.008"	1	1002	-1001
"390531"	"ALEXANDER PAAL GMBH"	"12.999.01.003"	-107	10	-117
"390531"	"ALEXANDER PAAL GMBH"	"12.999.01.008"	134	100	34
"390533"	"NEUHAUS"	"12.999.01.001"	89	0	89
"390533"	"NEUHAUS"	"12.999.01.003"	-84	0	-84
"390533"	"NEUHAUS"	"12.999.01.008"	201	72	129
"390534"	"TNT Innight GmbH & Co.KG"	"12.999.01.001"	73	56	17
"390534"	"TNT Innight GmbH & Co.KG"	"12.999.01.003"	4	1	3
"390537"	"MOHR + FRIEDRICH GMBH"	"12.999.01.001"	1	0	1
"390537"	"MOHR + FRIEDRICH GMBH"	"12.999.01.003"	-203	10	-213
"390537"	"MOHR + FRIEDRICH GMBH"	"12.999.01.008"	215	100	115
"390538"	"GUSTAV MEYER GMBH & CO."	"12.999.01.003"	7	0	7
"390538"	"GUSTAV MEYER GMBH & CO."	"12.999.01.008"	40	0	40
"390539"	"MAYER-JUMBO"	"12.999.01.001"	2	0	2
"390542"	"LST - GMBH"	"12.999.01.001"	-8	0	-8
"390542"	"LST - GMBH"	"12.999.01.003"	1	0	1
"390543"	"LIPPISCHE EISENINDUSTRIE GMBH"	"12.999.01.003"	-463	12	-475
"390543"	"LIPPISCHE EISENINDUSTRIE GMBH"	"12.999.01.008"	223	120	103
"390546"	"GESENK- UND FREIFORMSCHMIEDE"	"12.999.01.001"	-60	0	-60
"390555"	"KAUSEMANN GMBH"	"12.999.01.001"	6	0	6
"390556"	"JOHNSON DREHTECHNIK GMBH"	"12.999.01.003"	27	0	27
"390556"	"JOHNSON DREHTECHNIK GMBH"	"12.999.01.008"	45	0	45
"390557"	"WALTER HUNDHAUSEN GMBH"	"12.999.01.001"	-31	84	-115
"390557"	"WALTER HUNDHAUSEN GMBH"	"12.999.01.003"	-1	0	-1
"390560"	"HEINRICHS GMBH"	"12.999.01.001"	42	0	42
"390560"	"HEINRICHS GMBH"	"12.999.01.003"	0	2	-2
"390560"	"HEINRICHS GMBH"	"12.999.01.008"	10	8	2
"390563"	"GUEDE GMBH"	"12.999.01.003"	-7	0	-7
"390563"	"GUEDE GMBH"	"12.999.01.008"	-28	0	-28
"390564"	"Heinrich Glane GmbH"	"12.999.01.001"	-25	18	-43
"390564"	"Heinrich Glane GmbH"	"12.999.01.003"	-695	7	-702
"390564"	"Heinrich Glane GmbH"	"12.999.01.008"	0	4	-4
"390567"	"FUCHS SCHRAUBENWERK"	"12.999.01.003"	-32	9	-41
"390567"	"FUCHS SCHRAUBENWERK"	"12.999.01.008"	109	90	19
"390568"	"FORMTEIL- UND SCHRAUBENWERK"	"12.999.01.003"	140	5	135
"390569"	"AUGUST FRIEDBERG GMBH"	"12.999.01.003"	-186	39	-225
"390569"	"AUGUST FRIEDBERG GMBH"	"12.999.01.008"	346	330	16
"390570"	"FREUDENBERG SIMRIT KG"	"12.999.01.001"	-10	0	-10
"390570"	"FREUDENBERG SIMRIT KG"	"12.999.01.003"	-111	0	-111
"390571"	"ANDREAS FRANKE"	"12.999.01.003"	2	4	-2
"390572"	"Wälzlager GmbH"	"12.999.01.001"	1	0	1
"390572"	"Wälzlager GmbH"	"12.999.01.003"	-40	33	-73
"390572"	"Wälzlager GmbH"	"12.999.01.008"	575	330	245
"390574"	"SAF-Holland GmbH"	"12.999.01.001"	21	0	21
"390574"	"SAF-Holland GmbH"	"12.999.01.003"	-11	0	-11
"390574"	"SAF-Holland GmbH"	"12.999.01.008"	90	0	90
"390575"	"FELDMANN-MAB"	"12.999.01.003"	-17	0	-17
"390575"	"FELDMANN-MAB"	"12.999.01.008"	13	0	13
"390576"	"CFS FALKENROTH UMFORMTECHNIK"	"12.999.01.001"	14	0	14
"390577"	"ESAB GMBH"	"12.999.01.003"	-163	0	-163
"390580"	"RUDOLF ECKEL"	"12.999.01.001"	15	24	-9
"390580"	"RUDOLF ECKEL"	"12.999.01.003"	9	6	3
"390581"	"JOSEPH DRESSELHAUS"	"12.999.01.003"	-223	20	-243
"390581"	"JOSEPH DRESSELHAUS"	"12.999.01.008"	157	200	-43
"390583"	"Obermann Logistik GmbH"	"12.999.01.003"	-70	0	-70
"390587"	"Sped. Dachser GmbH & Co. KG"	"12.999.01.003"	-1	0	-1
"390596"	"BODYCOTE WÄRMEBEHANDLUNG GMBH"	"12.999.01.003"	0	2	-2
"390596"	"BODYCOTE WÄRMEBEHANDLUNG GMBH"	"12.999.01.008"	0	8	-8
"404089"	"Rejna"	"12.999.01.001"	1	0	1
"404404"	"TPV d.d."	"12.999.01.001"	130	0	130
"406692"	"SLR-GUSSWERK II"	"12.999.01.001"	6	0	6
"408204"	"LECITRAILER S.A."	"12.999.01.001"	2	0	2
"408237"	"FUNDICIONES DE VERA S.A."	"12.999.01.001"	1	8	-7
"408237"	"FUNDICIONES DE VERA S.A."	"12.999.01.003"	295	400	-105
"408402"	"DRECHSEL & KOLLAR KFT"	"12.999.01.188"	-5	0	-5
"409002"	"F. X. MEILLER SLANY S.R.O."	"12.999.01.001"	81	33	48
"409002"	"F. X. MEILLER SLANY S.R.O."	"12.999.01.003"	10	6	4
"409002"	"F. X. MEILLER SLANY S.R.O."	"12.999.01.008"	3	2	1
"409002"	"F. X. MEILLER SLANY S.R.O."	"12.999.01.162"	16	4	12
"409002"	"F. X. MEILLER SLANY S.R.O."	"12.999.01.163"	4	1	3
"409002"	"F. X. MEILLER SLANY S.R.O."	"12.999.01.188"	43	53	-10
"409004"	"BRANO A.S."	"12.999.01.001"	52	176	-124
"409004"	"BRANO A.S."	"12.999.01.003"	3	1	2
"416670"	"FAHRZEUGBEDARF"	"12.999.01.001"	172	197	-25
"416670"	"FAHRZEUGBEDARF"	"12.999.01.003"	310	487	-177
"416670"	"FAHRZEUGBEDARF"	"12.999.01.008"	12	49	-37
"416670"	"FAHRZEUGBEDARF"	"12.999.01.162"	52	78	-26
"416670"	"FAHRZEUGBEDARF"	"12.999.01.163"	11	11	0
"416674"	"Hendrickson Austria GmbH"	"12.999.01.001"	227	54	173
"416674"	"Hendrickson Austria GmbH"	"12.999.01.003"	2	604	-602
"490102"	"KUZNIA GLINIK SP.Z.O.O."	"12.999.01.001"	-15	0	-15
"490106"	"FORGING PRODUCTS S.A."	"12.999.01.001"	-15	60	-75
"490106"	"FORGING PRODUCTS S.A."	"12.999.01.003"	-50	11	-61
"490106"	"FORGING PRODUCTS S.A."	"12.999.01.008"	23	0	23
"490108"	"KAMAX S.R.O. TURNOV"	"12.999.01.003"	-34	0	-34
"490112"	"UNIOR DD"	"12.999.01.003"	94	0	94
"490112"	"UNIOR DD"	"12.999.01.008"	81	0	81
"500005"	"DUMMY-Sonderbestandsführer"	"12.999.01.001"	523	1	522
"500005"	"DUMMY-Sonderbestandsführer"	"12.999.01.003"	1	1	0
"500005"	"DUMMY-Sonderbestandsführer"	"12.999.01.008"	99	2	97
"500005"	"DUMMY-Sonderbestandsführer"	"12.999.01.011"	-2	0	-2
"500005"	"DUMMY-Sonderbestandsführer"	"12.999.01.162"	240	0	240
"500005"	"DUMMY-Sonderbestandsführer"	"12.999.01.163"	63	0	63
"500005"	"DUMMY-Sonderbestandsführer"	"12.999.01.188"	115	0	115
"500023"	"BPW Bergische Achsen KG"	"12.999.01.188"	0	0	0
"500035"	"EUROPART Materials GmbH"	"12.999.01.001"	69	77	-8
"500035"	"EUROPART Materials GmbH"	"12.999.01.003"	88	102	-14
"500035"	"EUROPART Materials GmbH"	"12.999.01.008"	1	0	1
"500110"	"Karl Raudzus & Söhne"	"12.999.01.001"	0	1	-1
"500118"	"Cargobull Parts & Services GmbH"	"12.999.01.001"	7	21	-14
"500118"	"Cargobull Parts & Services GmbH"	"12.999.01.003"	0	1	-1
"500167"	"MN Kaltformteile"	"12.999.01.003"	-11	0	-11
"500219"	"Georg Fischer GmbH"	"12.999.01.001"	-216	307	-523
"500219"	"Georg Fischer GmbH"	"12.999.01.003"	36	1	35
"500219"	"Georg Fischer GmbH"	"12.999.01.008"	79	0	79
"500245"	"NTV Nutzfahrzeuge"	"12.999.01.001"	2	0	2
"500291"	"SVG EUROPART Südbaden GmbH"	"12.999.01.003"	0	1	-1
"500304"	"EUROPART Trading GmbH"	"12.999.01.001"	1	0	1
"500310"	"Spermann Fahrzeugbau GmbH"	"12.999.01.001"	2	1	1
"500310"	"Spermann Fahrzeugbau GmbH"	"12.999.01.003"	2	1	1
"500331"	"SW Umformtechnik"	"12.999.01.001"	12	20	-8
"500331"	"SW Umformtechnik"	"12.999.01.003"	151	50	101
"500376"	"Menke Spezial-Transporte"	"12.999.01.001"	0	0	0
"500398"	"TROST AUTO SERVICE TECHNIK SE"	"12.999.01.003"	1	1	0
"500570"	"RI-FA"	"12.999.01.001"	1	1	0
"500570"	"RI-FA"	"12.999.01.003"	1	1	0
"500608"	"ATLAS NORDHESSEN bopp fahrzeug-"	"12.999.01.003"	0	2	-2
"500621"	"PROFI PARTS"	"12.999.01.001"	2	0	2
"500706"	"HGE Fahrzeugbau GmbH & Co. KG"	"12.999.01.001"	1	1	0
"500706"	"HGE Fahrzeugbau GmbH & Co. KG"	"12.999.01.188"	1	1	0
"500757"	"TROST AUTO SERVICE TECHNIK SE"	"12.999.01.001"	1	0	1
"500783"	"TROST AUTO SERVICE TECHNIK SE"	"12.999.01.003"	0	1	-1
"500800"	"Paul Scholz KG"	"12.999.01.003"	1	1	0
"500820"	"Hofmeister & Meincke GmbH & Co. KG"	"12.999.01.001"	1	0	1
"501044"	"Friedrich Kraft GmbH"	"12.999.01.001"	2	6	-4
"501044"	"Friedrich Kraft GmbH"	"12.999.01.003"	1	2	-1
"501100"	"Stürenberg Fahrzeugbau GmbH"	"12.999.01.001"	1	1	0
"501100"	"Stürenberg Fahrzeugbau GmbH"	"12.999.01.003"	1	1	0
"501146"	"Schwarzmüller"	"12.999.01.188"	43	104	-61
"501182"	"DUMMY-Warenempfänger Aftermarket"	"12.999.01.001"	0	0	0
"501210"	"WüTSCHNER"	"12.999.01.001"	0	27	-27
"501210"	"WüTSCHNER"	"12.999.01.003"	0	6	-6
"501221"	"Polyma Energiesysteme GmbH"	"12.999.01.001"	2	0	2
"501233"	"OPTIMAS OE Solutions GmbH"	"12.999.01.003"	-66	0	-66
"501233"	"OPTIMAS OE Solutions GmbH"	"12.999.01.008"	41	0	41
"501243"	"Altha Industrieprodukte"	"12.999.01.003"	18	4	14
"501243"	"Altha Industrieprodukte"	"12.999.01.008"	2	40	-38
"501305"	"Kuznia Jawor SA"	"12.999.01.001"	80	60	20
"501398"	"BIRNER GMBH"	"12.999.01.001"	2	0	2
"501401"	"Bäumle Spedition GmbH"	"12.999.01.001"	1	0	1
"501401"	"Bäumle Spedition GmbH"	"12.999.01.003"	2	0	2
"501473"	"Herbert Dammann GmbH"	"12.999.01.001"	1	0	1
"501508"	"A-W.Heil & Sohn GmbH & Co."	"12.999.01.001"	12	15	-3
"501508"	"A-W.Heil & Sohn GmbH & Co."	"12.999.01.003"	13	5	8
"501592"	"Paul Link GmbH & Co. KG"	"12.999.01.003"	1	1	0
"501620"	"Fietz Thermoplast"	"12.999.01.003"	-14	0	-14
"501681"	"TROST AUTO SERVICE TECHNIK SE"	"12.999.01.001"	1	0	1
"501953"	"K & S Keil"	"12.999.01.001"	0	0	0
"502119"	"Claas Service and Parts GmbH"	"12.999.01.001"	0	1	-1
"502119"	"Claas Service and Parts GmbH"	"12.999.01.003"	0	2	-2
"502119"	"Claas Service and Parts GmbH"	"12.999.01.008"	25	0	25
"502159"	"Kurt Willig"	"12.999.01.003"	1	1	0
"502219"	"Maschinenfabrik Bernard Krone GmbH"	"12.999.01.001"	0	0	0
"502219"	"Maschinenfabrik Bernard Krone GmbH"	"12.999.01.003"	1	2	-1
"502219"	"Maschinenfabrik Bernard Krone GmbH"	"12.999.01.008"	0	0	0
"502548"	"Spedition Hefter"	"12.999.01.003"	0	1	-1
"502560"	"Haerterei Hauck"	"12.999.01.001"	-7	0	-7
"502560"	"Haerterei Hauck"	"12.999.01.003"	-24	0	-24
"502560"	"Haerterei Hauck"	"12.999.01.008"	36	0	36
"502680"	"Finkl-Fahrzeugbau GmbH"	"12.999.01.001"	1	6	-5
"502680"	"Finkl-Fahrzeugbau GmbH"	"12.999.01.003"	1	7	-6
"502809"	"Franz Mersch GmbH & Co. KG"	"12.999.01.001"	1	2	-1
"502942"	"MAN NUTZFAHRZEUGE VERTRIEB GMBH"	"12.999.01.003"	0	0	0
"503038"	"Weißgerber/Seidner GmbH & Co"	"12.999.01.001"	78	60	18
"503038"	"Weißgerber/Seidner GmbH & Co"	"12.999.01.003"	56	63	-7
"503131"	"Contitech Luftfedersysteme GmbH"	"12.999.01.001"	-7	0	-7
"503173"	"Bohnet GmbH"	"12.999.01.001"	5	0	5
"503208"	"Rainer Volk"	"12.999.01.001"	2	0	2
"503240"	"Wessels Vrees"	"12.999.01.001"	10	1	9
"503269"	"Sinco Tec"	"12.999.01.001"	4	0	4
"503313"	"Kaiser Fahrzeugbau GmbH"	"12.999.01.001"	2	2	0
"503313"	"Kaiser Fahrzeugbau GmbH"	"12.999.01.003"	1	1	0
"503313"	"Kaiser Fahrzeugbau GmbH"	"12.999.01.188"	1	1	0
"503356"	"Arnold Umformtechnik"	"12.999.01.003"	8	4	4
"503371"	"Heinrich Kruse"	"12.999.01.001"	1	0	1
"503490"	"B. Stade, Inh. M. Stade"	"12.999.01.001"	0	0	0
"503490"	"B. Stade, Inh. M. Stade"	"12.999.01.003"	1	1	0
"503494"	"VCT Vogel GmbH"	"12.999.01.001"	2	2	0
"503494"	"VCT Vogel GmbH"	"12.999.01.003"	1	1	0
"503494"	"VCT Vogel GmbH"	"12.999.01.188"	0	0	0
"503634"	"Wessels + Müller AG"	"12.999.01.001"	1	0	1
"503638"	"Fahrzeugbau GmbH Ladeburg"	"12.999.01.001"	0	1	-1
"503638"	"Fahrzeugbau GmbH Ladeburg"	"12.999.01.003"	0	1	-1
"503996"	"System Trailers GmbH"	"12.999.01.001"	73	45	28
"503996"	"System Trailers GmbH"	"12.999.01.003"	37	39	-2
"503996"	"System Trailers GmbH"	"12.999.01.008"	12	1	11
"503996"	"System Trailers GmbH"	"12.999.01.162"	20	4	16
"503996"	"System Trailers GmbH"	"12.999.01.163"	5	1	4
"503996"	"System Trailers GmbH"	"12.999.01.188"	74	70	4
"504307"	"Zemmler"	"12.999.01.001"	1	3	-2
"504307"	"Zemmler"	"12.999.01.003"	1	3	-2
"504335"	"MAN Truck & Bus Deutschland GmbH"	"12.999.01.003"	1	1	0
"504337"	"RUFA Fahrzeugbau GmbH"	"12.999.01.001"	5	11	-6
"504337"	"RUFA Fahrzeugbau GmbH"	"12.999.01.003"	1	5	-4
"504337"	"RUFA Fahrzeugbau GmbH"	"12.999.01.162"	4	0	4
"504337"	"RUFA Fahrzeugbau GmbH"	"12.999.01.163"	1	0	1
"504337"	"RUFA Fahrzeugbau GmbH"	"12.999.01.188"	10	6	4
"504462"	"TMD Friction  GmbH Coswig"	"12.999.01.003"	3	0	3
"504483"	"Streicher Landmaschinen GmbH"	"12.999.01.001"	1	0	1
"504659"	"Hellmut Schmied Spedition"	"12.999.01.003"	1	1	0
"504689"	"HS-Schoch GmbH"	"12.999.01.001"	-73	0	-73
"504689"	"HS-Schoch GmbH"	"12.999.01.003"	-129	225	-354
"504689"	"HS-Schoch GmbH"	"12.999.01.008"	0	14	-14
"504728"	"Grimme Landmaschinentechnik"	"12.999.01.001"	11	0	11
"504728"	"Grimme Landmaschinentechnik"	"12.999.01.003"	1	0	1
"504728"	"Grimme Landmaschinentechnik"	"12.999.01.008"	4	1	3
"504754"	"Söllner Transport & logistics"	"12.999.01.001"	0	0	0
"504824"	"Spedition Eberhard Gersch"	"12.999.01.003"	1	1	0
"504864"	"Lenicker GmbH"	"12.999.01.001"	2	1	1
"504880"	"Lisi Automotive-Knipping"	"12.999.01.003"	-10	0	-10
"504880"	"Lisi Automotive-Knipping"	"12.999.01.008"	0	6	-6
"504902"	"Peter Ortmann"	"12.999.01.001"	1	1	0
"505139"	"Karosserie- u. Fahrzeugbau"	"12.999.01.001"	0	0	0
"505279"	"Reiner Reichert"	"12.999.01.001"	1	1	0
"505279"	"Reiner Reichert"	"12.999.01.188"	2	2	0
"505303"	"Kurt Willig GmbH & Co. KG"	"12.999.01.001"	0	7	-7
"505303"	"Kurt Willig GmbH & Co. KG"	"12.999.01.003"	4	5	-1
"505303"	"Kurt Willig GmbH & Co. KG"	"12.999.01.008"	0	3	-3
"505303"	"Kurt Willig GmbH & Co. KG"	"12.999.01.162"	2	2	0
"505303"	"Kurt Willig GmbH & Co. KG"	"12.999.01.163"	1	1	0
"505303"	"Kurt Willig GmbH & Co. KG"	"12.999.01.188"	14	11	3
"505463"	"Nutzfahrzeug & Service"	"12.999.01.001"	0	0	0
"505463"	"Nutzfahrzeug & Service"	"12.999.01.003"	0	0	0
"505485"	"ELHA Maschinenbau"	"12.999.01.001"	-7	0	-7
"505485"	"ELHA Maschinenbau"	"12.999.01.003"	2	0	2
"505515"	"RMW Rotenburger"	"12.999.01.003"	34	0	34
"505519"	"Brueggen Komponenten GmbH"	"12.999.01.001"	808	99	709
"505519"	"Brueggen Komponenten GmbH"	"12.999.01.003"	15	5	10
"505519"	"Brueggen Komponenten GmbH"	"12.999.01.008"	22	10	12
"505519"	"Brueggen Komponenten GmbH"	"12.999.01.162"	16	0	16
"505519"	"Brueggen Komponenten GmbH"	"12.999.01.163"	3	0	3
"505519"	"Brueggen Komponenten GmbH"	"12.999.01.188"	91	192	-101
"505548"	"Colombo Special Fasteners"	"12.999.01.003"	39	27	12
"505548"	"Colombo Special Fasteners"	"12.999.01.008"	166	70	96
"505567"	"HOYER"	"12.999.01.001"	1	0	1
"505633"	"Europart Trading GmbH"	"12.999.01.001"	0	0	0
"505663"	"Schaeffler  KG"	"12.999.01.003"	-1	0	-1
"505664"	"Springfix"	"12.999.01.003"	-8	0	-8
"505666"	"Pöppelmann GmbH & Co."	"12.999.01.001"	0	1	-1
"505666"	"Pöppelmann GmbH & Co."	"12.999.01.003"	-11	0	-11
"505668"	"Willi Hahn GmbH"	"12.999.01.003"	-7	0	-7
"505695"	"Knoll GmbH"	"12.999.01.001"	-2	0	-2
"505735"	"Südbeck"	"12.999.01.001"	1	0	1
"505737"	"Vollmer + Boch"	"12.999.01.001"	45	0	45
"505737"	"Vollmer + Boch"	"12.999.01.003"	42	0	42
"505738"	"Mildner Fahrzeugbau GmbH"	"12.999.01.001"	41	16	25
"505738"	"Mildner Fahrzeugbau GmbH"	"12.999.01.003"	9	19	-10
"505738"	"Mildner Fahrzeugbau GmbH"	"12.999.01.008"	6	4	2
"505738"	"Mildner Fahrzeugbau GmbH"	"12.999.01.188"	1	1	0
"505856"	"CT Kran-Cervice GmbH"	"12.999.01.001"	2	1	1
"505910"	"Wilhelm Schauerte"	"12.999.01.001"	-18	8	-26
"505910"	"Wilhelm Schauerte"	"12.999.01.003"	9	12	-3
"505910"	"Wilhelm Schauerte"	"12.999.01.008"	8	0	8
"505994"	"Thimm Verpackung GmbH & Co."	"12.999.01.003"	-31	0	-31
"506215"	"Walter Fink"	"12.999.01.001"	1	0	1
"506371"	"LS Kunststofftechnologie GmbH"	"12.999.01.003"	-26	60	-86
"506466"	"BayWa AG Obertraubling"	"12.999.01.001"	1	0	1
"506695"	"Rauch Landmaschinenfabrik Gmbh"	"12.999.01.008"	1	0	1
"506832"	"Johann Vitz GmbH & Co. KG"	"12.999.01.003"	-8	19	-27
"506991"	"Eurotank GmbH"	"12.999.01.001"	5	5	0
"506991"	"Eurotank GmbH"	"12.999.01.008"	1	1	0
"506991"	"Eurotank GmbH"	"12.999.01.188"	3	3	0
"507049"	"Tenneco Automotive"	"12.999.01.001"	0	25	-25
"507063"	"Liebherr-Mischtechnik GmbH"	"12.999.01.003"	1	1	0
"507063"	"Liebherr-Mischtechnik GmbH"	"12.999.01.008"	0	0	0
"507254"	"TH Baumaschinen"	"12.999.01.001"	0	0	0
"507513"	"Gottschalk GmbH"	"12.999.01.001"	0	0	0
"507513"	"Gottschalk GmbH"	"12.999.01.003"	0	0	0
"507539"	"Benninghoven"	"12.999.01.003"	2	0	2
"507597"	"Kögel Trailer GmbH & Co. KG"	"12.999.01.001"	16	30	-14
"507597"	"Kögel Trailer GmbH & Co. KG"	"12.999.01.003"	2	2	0
"507597"	"Kögel Trailer GmbH & Co. KG"	"12.999.01.008"	2	3	-1
"507597"	"Kögel Trailer GmbH & Co. KG"	"12.999.01.162"	2	2	0
"507597"	"Kögel Trailer GmbH & Co. KG"	"12.999.01.163"	1	1	0
"507597"	"Kögel Trailer GmbH & Co. KG"	"12.999.01.188"	96	94	2
"507646"	"Mager GmbH"	"12.999.01.001"	-12	0	-12
"507646"	"Mager GmbH"	"12.999.01.003"	4	0	4
"507646"	"Mager GmbH"	"12.999.01.008"	19	0	19
"507679"	"Amazone Technologie Leeden"	"12.999.01.008"	1	0	1
"507683"	"MTE"	"12.999.01.001"	1	1	0
"507737"	"Möller Fahrzeugbau"	"12.999.01.001"	1	0	1
"507737"	"Möller Fahrzeugbau"	"12.999.01.008"	1	0	1
"507738"	"Eckstein GmbH & Co.KG"	"12.999.01.001"	7	0	7
"507738"	"Eckstein GmbH & Co.KG"	"12.999.01.003"	12	2	10
"507778"	"Breuer & Wasel GmbH"	"12.999.01.001"	1	0	1
"508122"	"Reinhard Darming"	"12.999.01.003"	1	1	0
"508162"	"Zuern Harvesting GmbH & Co. KG"	"12.999.01.001"	5	2	3
"508219"	"TROST AUTO SERVICE TECHNIK SE"	"12.999.01.001"	9	23	-14
"508219"	"TROST AUTO SERVICE TECHNIK SE"	"12.999.01.003"	1	3	-2
"508293"	"Pankoke & Roll GmbH & Co.KG"	"12.999.01.001"	3	3	0
"508628"	"Beilharz Nutzfahrzeuge Duisburg Gmb"	"12.999.01.001"	15	4	11
"508628"	"Beilharz Nutzfahrzeuge Duisburg Gmb"	"12.999.01.003"	4	3	1
"508794"	"Agravis Technik Saltenbrock GmbH"	"12.999.01.001"	1	0	1
"508946"	"He - Wa Aufbau"	"12.999.01.001"	5	1	4
"508946"	"He - Wa Aufbau"	"12.999.01.003"	4	1	3
"508946"	"He - Wa Aufbau"	"12.999.01.008"	3	0	3
"508979"	"Lemmer GmbH & Co. KG"	"12.999.01.001"	-82	0	-82
"508979"	"Lemmer GmbH & Co. KG"	"12.999.01.003"	89	0	89
"508979"	"Lemmer GmbH & Co. KG"	"12.999.01.008"	40	0	40
"509379"	"Vibracoustic CV Air Springs"	"12.999.01.001"	103	1200	-1097
"509379"	"Vibracoustic CV Air Springs"	"12.999.01.003"	18	0	18
"509379"	"Vibracoustic CV Air Springs"	"12.999.01.008"	22	0	22
"509460"	"Frauenthal Automotive"	"12.999.01.001"	75	0	75
"509460"	"Frauenthal Automotive"	"12.999.01.003"	58	116	-58
"509460"	"Frauenthal Automotive"	"12.999.01.008"	259	260	-1
"509494"	"TIP Trailer Services Germany GmbH"	"12.999.01.003"	2	2	0
"509890"	"HZ - Elbe Autoersatzt.. GmbH & CO."	"12.999.01.001"	1	0	1
"509953"	"PM Hermann Perk"	"12.999.01.001"	2	0	2
"509953"	"PM Hermann Perk"	"12.999.01.008"	1	0	1
"510352"	"Autohaus Anders GmbH"	"12.999.01.001"	1	0	1
"510569"	"FLEXIMOL"	"12.999.01.001"	56	0	56
"510569"	"FLEXIMOL"	"12.999.01.003"	-3	0	-3
"510666"	"Släpis AB"	"12.999.01.003"	0	1	-1
"510871"	"Lohnunternehmen Blunk"	"12.999.01.001"	0	0	0
"510946"	"Sebastian Obermaier"	"12.999.01.001"	1	0	1
"510946"	"Sebastian Obermaier"	"12.999.01.003"	1	0	1
"511014"	"DFF Federn und Fahrzeugteile GmbH"	"12.999.01.001"	0	0	0
"511014"	"DFF Federn und Fahrzeugteile GmbH"	"12.999.01.003"	0	2	-2
"511057"	"STA GmbH"	"12.999.01.001"	0	0	0
"511312"	"HNT Härtling"	"12.999.01.001"	0	0	0
"511327"	"Rübsam & Co."	"12.999.01.001"	3	0	3
"511327"	"Rübsam & Co."	"12.999.01.008"	11	0	11
"511577"	"Friedrich Kraft GmbH"	"12.999.01.001"	0	0	0
"511885"	"CIMC Silvergreen Germany GmbH"	"12.999.01.001"	1	0	1
"511885"	"CIMC Silvergreen Germany GmbH"	"12.999.01.188"	23	0	23
"511928"	"Kögel, s. r. o."	"12.999.01.001"	-30	18	-48
"511928"	"Kögel, s. r. o."	"12.999.01.003"	2	0	2
"512068"	"SIGA Fahrzeugtechnik"	"12.999.01.188"	1	0	1
"512130"	"Walkliner GmbH"	"12.999.01.001"	0	0	0
"512130"	"Walkliner GmbH"	"12.999.01.188"	0	0	0
"512338"	"H & W"	"12.999.01.001"	3	11	-8
"512338"	"H & W"	"12.999.01.003"	3	13	-10
"512338"	"H & W"	"12.999.01.008"	4	5	-1
"512338"	"H & W"	"12.999.01.162"	6	2	4
"512338"	"H & W"	"12.999.01.163"	2	1	1
"512338"	"H & W"	"12.999.01.188"	2	1	1
"512578"	"TBZ GmbH"	"12.999.01.001"	6	1	5
"512578"	"TBZ GmbH"	"12.999.01.003"	6	1	5
"512611"	"K+G tec GmbH"	"12.999.01.001"	3	3	0
"512611"	"K+G tec GmbH"	"12.999.01.188"	6	6	0
"512620"	"Fellechner Fahrzeugbau GmbH"	"12.999.01.001"	4	4	0
"512620"	"Fellechner Fahrzeugbau GmbH"	"12.999.01.003"	1	3	-2
"512620"	"Fellechner Fahrzeugbau GmbH"	"12.999.01.008"	2	2	0
"512620"	"Fellechner Fahrzeugbau GmbH"	"12.999.01.188"	2	2	0
"512789"	"Huster GmbH"	"12.999.01.001"	1	0	1
"512808"	"Fischl Fahrzeugbau GmbH"	"12.999.01.001"	0	0	0
"512808"	"Fischl Fahrzeugbau GmbH"	"12.999.01.003"	0	0	0
"512847"	"GEREP"	"12.999.01.001"	-9	0	-9
"512886"	"Exporient Middle East for"	"12.999.01.003"	0	0	0
"512917"	"UPS Deutschland Inc. & Co. OHG"	"12.999.01.003"	0	1	-1
"512941"	"E. Heidrich"	"12.999.01.001"	1	0	1
"512945"	"Wagner GmbH"	"12.999.01.001"	0	0	0
"513076"	"Spedition Calenberg"	"12.999.01.001"	3	0	3
"513211"	"Schuler Fahrzeugbau GmbH"	"12.999.01.001"	6	2	4
"513211"	"Schuler Fahrzeugbau GmbH"	"12.999.01.162"	0	0	0
"513211"	"Schuler Fahrzeugbau GmbH"	"12.999.01.163"	0	0	0
"513721"	"Kumm Technik GmbH"	"12.999.01.001"	1	0	1
"513721"	"Kumm Technik GmbH"	"12.999.01.003"	2	0	2
"513775"	"Kreitz"	"12.999.01.001"	1	0	1
"514085"	"NTV Nutzfahrzeugteile Oesterhaus KG"	"12.999.01.001"	1	1	0
"514123"	"Michael Kumm GmbH"	"12.999.01.001"	0	0	0
"514270"	"IVECO"	"12.999.01.003"	0	1	-1
"514300"	"Otto Fuchs KG"	"12.999.01.003"	9	15	-6
"514300"	"Otto Fuchs KG"	"12.999.01.008"	57	0	57
"514346"	"Prodinger oHG"	"12.999.01.003"	-8	0	-8
"514535"	"CTJ Janssen GmbH"	"12.999.01.001"	1	0	1
"514868"	"BMD Baumechanisierung"	"12.999.01.001"	1	0	1
"516700"	"Gebr. Unger"	"12.999.01.001"	0	0	0
"518187"	"Modschiedler Logistik GmbH"	"12.999.01.001"	1	1	0
"520059"	"BST - Transporte"	"12.999.01.001"	1	0	1
"520059"	"BST - Transporte"	"12.999.01.003"	2	0	2
"520549"	"Georg Wagner KG"	"12.999.01.001"	3	0	3
"520549"	"Georg Wagner KG"	"12.999.01.003"	4	0	4
"522748"	"Grieshaber Logistik AG"	"12.999.01.001"	1	0	1
"523639"	"Hofmeister & Meincke GmbH & Co.KG"	"12.999.01.001"	1	1	0
"523733"	"TAXO-Obermaier  GmbH"	"12.999.01.003"	1	1	0
"523740"	"Fasieco GmbH"	"12.999.01.001"	2	0	2
"523768"	"Moehling GmbH"	"12.999.01.003"	-29	8	-37
"523768"	"Moehling GmbH"	"12.999.01.008"	72	66	6
"523926"	"Forma Maschinenbau"	"12.999.01.001"	16	16	0
"523926"	"Forma Maschinenbau"	"12.999.01.008"	12	8	4
"523974"	"A6 Nutzfahrzeuge GmbH & Co. KG"	"12.999.01.001"	0	0	0
"523974"	"A6 Nutzfahrzeuge GmbH & Co. KG"	"12.999.01.003"	0	1	-1
"523992"	"Dennis Struß"	"12.999.01.001"	1	0	1
"524088"	"ZAL GmbH"	"12.999.01.001"	1	0	1
"524141"	"Karl Groll GmbH + Co. KG"	"12.999.01.001"	3	0	3
"524459"	"Schreibmüller"	"12.999.01.001"	1	0	1
"524459"	"Schreibmüller"	"12.999.01.003"	1	0	1
"524464"	"Schondelmaier GmbH"	"12.999.01.001"	20	0	20
"524464"	"Schondelmaier GmbH"	"12.999.01.003"	1	0	1
"524478"	"Vibracoustic Polska SP. ZO.O."	"12.999.01.001"	1	0	1
"524478"	"Vibracoustic Polska SP. ZO.O."	"12.999.01.003"	8	0	8
"524507"	"Landwirtschaftsbetrieb Rienitz"	"12.999.01.003"	1	0	1
"524507"	"Landwirtschaftsbetrieb Rienitz"	"12.999.01.008"	1	0	1
"524775"	"Neumeister Hydraulik GmbH"	"12.999.01.001"	5	0	5
"524775"	"Neumeister Hydraulik GmbH"	"12.999.01.003"	1	0	1
"524775"	"Neumeister Hydraulik GmbH"	"12.999.01.008"	7	0	7
"525106"	"Trost Auto Service Technik"	"12.999.01.001"	5	0	5
"525106"	"Trost Auto Service Technik"	"12.999.01.003"	3	0	3
"525395"	"Toni Hotz Transporte"	"12.999.01.001"	3	0	3
"525422"	"Rasche"	"12.999.01.001"	-8	60	-68
"525611"	"Massfeller GmbH"	"12.999.01.001"	2	0	2
"525936"	"Wolfgang Wagenblast"	"12.999.01.001"	1	1	0
"526214"	"JW-TEC"	"12.999.01.001"	1	0	1
"526214"	"JW-TEC"	"12.999.01.188"	1	0	1
"526228"	"BC Trans GmbH & Co. KG"	"12.999.01.001"	1	0	1
"526329"	"Gorica Industries LLC"	"12.999.01.003"	0	1	-1
"526372"	"Trost Auto Service Technik SE"	"12.999.01.001"	44	36	8
"526372"	"Trost Auto Service Technik SE"	"12.999.01.003"	55	8	47
"526405"	"Unipro"	"12.999.01.001"	1	0	1
"526481"	"ASEAG GmbH"	"12.999.01.001"	1	0	1
"526506"	"BHC Gummi-Metall GmbH"	"12.999.01.001"	-44	60	-104
"527504"	"AI Metalltechnik GmbH & Co. KG"	"12.999.01.001"	9	5	4
"527641"	"Winkler Fahrzeugteile GmbH"	"12.999.01.001"	1	0	1
"527678"	"SVG Autohof Stuttgart-Wangen"	"12.999.01.001"	1	0	1
"527681"	"A.-W. Heil & Sohn GmbH & Co. KG"	"12.999.01.001"	3	3	0
"527702"	"Wütschner Fahrzeugteile GmbH"	"12.999.01.001"	1	8	-7
"527818"	"WM SE"	"12.999.01.001"	8	1	7
"527818"	"WM SE"	"12.999.01.003"	5	4	1
"528226"	"Rotor Clip"	"12.999.01.003"	-57	4	-61
"528226"	"Rotor Clip"	"12.999.01.008"	46	40	6
"528272"	"Pagenkopf Fahrzeugtechnik"	"12.999.01.001"	10	3	7
"528272"	"Pagenkopf Fahrzeugtechnik"	"12.999.01.003"	14	3	11
"528429"	"NICO Fahrzeugteile GmbH"	"12.999.01.001"	0	1	-1
"528653"	"FVG GmbH & Co. KG"	"12.999.01.001"	1	4	-3
"528653"	"FVG GmbH & Co. KG"	"12.999.01.003"	3	6	-3
"528771"	"Zanner Fahrzeugbau GmbH"	"12.999.01.001"	2	0	2
"528771"	"Zanner Fahrzeugbau GmbH"	"12.999.01.003"	1	0	1
"529079"	"sfb Schönebecker Fahrzeugbau GmbH"	"12.999.01.003"	0	0	0
"529163"	"Frimatec Ing. GmbH"	"12.999.01.003"	4	4	0
"529351"	"Bavaria Schweisstechnik"	"12.999.01.001"	112	30	82
"529351"	"Bavaria Schweisstechnik"	"12.999.01.003"	-55	0	-55
"529383"	"Gabler Transport & Handel"	"12.999.01.001"	1	0	1
"529513"	"DOLL"	"12.999.01.001"	37	48	-11
"529513"	"DOLL"	"12.999.01.003"	-4	27	-31
"529513"	"DOLL"	"12.999.01.008"	4	5	-1
"529513"	"DOLL"	"12.999.01.162"	12	13	-1
"529513"	"DOLL"	"12.999.01.163"	7	7	0
"529513"	"DOLL"	"12.999.01.188"	11	6	5
"529520"	"Doll Sachsen GmbH"	"12.999.01.001"	5	7	-2
"529520"	"Doll Sachsen GmbH"	"12.999.01.003"	13	1	12
"529520"	"Doll Sachsen GmbH"	"12.999.01.008"	2	2	0
"529520"	"Doll Sachsen GmbH"	"12.999.01.162"	4	4	0
"529520"	"Doll Sachsen GmbH"	"12.999.01.163"	1	1	0
"529520"	"Doll Sachsen GmbH"	"12.999.01.188"	2	1	1
"529551"	"Stefan Kohrs"	"12.999.01.001"	1	0	1
"529666"	"Wilhelm Severt Maschinenbau GmbH"	"12.999.01.001"	2	0	2
"529666"	"Wilhelm Severt Maschinenbau GmbH"	"12.999.01.003"	2	0	2
"529734"	"Max Streicher GmbH & Co."	"12.999.01.001"	2	0	2
"529741"	"Firestone Industrial Products"	"12.999.01.001"	143	180	-37
"529864"	"WEISSENBURG Industrie-Technik"	"12.999.01.003"	0	3	-3
"529894"	"Freidrich Kraft GmbH"	"12.999.01.001"	1	0	1
"529894"	"Freidrich Kraft GmbH"	"12.999.01.003"	1	1	0
"529947"	"Haas Fahrzeugtechnik GmbH"	"12.999.01.001"	0	2	-2
"529947"	"Haas Fahrzeugtechnik GmbH"	"12.999.01.003"	0	2	-2
"529985"	"Luhn & Pulvermacher"	"12.999.01.001"	26	0	26
"529986"	"LEISE GMBH & CO. KG"	"12.999.01.001"	3	0	3
"530076"	"Dreher und Schulz GbR"	"12.999.01.001"	1	0	1
"530183"	"Hermann Fliess & Co. GmbH"	"12.999.01.003"	-36	21	-57
"530310"	"Josef König-Krölleke"	"12.999.01.001"	1	0	1
"530333"	"Monroe Czechia S.R.O."	"12.999.01.001"	127	96	31
"530338"	"BWO"	"12.999.01.001"	197	43	154
"530338"	"BWO"	"12.999.01.003"	9	0	9
"530356"	"Autohaus Widmann"	"12.999.01.001"	1	0	1
"530356"	"Autohaus Widmann"	"12.999.01.003"	2	0	2
"530478"	"HTD-Trailers GmbH"	"12.999.01.001"	6	2	4
"530478"	"HTD-Trailers GmbH"	"12.999.01.003"	2	2	0
"530478"	"HTD-Trailers GmbH"	"12.999.01.008"	3	0	3
"530478"	"HTD-Trailers GmbH"	"12.999.01.162"	8	0	8
"530478"	"HTD-Trailers GmbH"	"12.999.01.163"	2	0	2
"530536"	"MAT Commercial Vehicle"	"12.999.01.001"	6	11	-5
"530536"	"MAT Commercial Vehicle"	"12.999.01.003"	20	20	0
"530536"	"MAT Commercial Vehicle"	"12.999.01.008"	46	61	-15
"530621"	"Schenker (D) AG - Zebel (H)"	"12.999.01.008"	1	0	1
"530652"	"Waeles Nederland BV"	"12.999.01.001"	-39	0	-39
"530655"	"Walter Denoth"	"12.999.01.001"	1	0	1
"530698"	"Schnaithmann Maschinenbau GmbH"	"12.999.01.001"	0	4	-4
"530698"	"Schnaithmann Maschinenbau GmbH"	"12.999.01.003"	0	0	0
"530698"	"Schnaithmann Maschinenbau GmbH"	"12.999.01.008"	0	7	-7
"530761"	"Matthias Kühl"	"12.999.01.001"	1	0	1
"530761"	"Matthias Kühl"	"12.999.01.003"	1	0	1
"530813"	"Sievering"	"12.999.01.001"	2	0	2
"530901"	"Kammerer-Reifen GmbH"	"12.999.01.001"	1	1	0
"530901"	"Kammerer-Reifen GmbH"	"12.999.01.003"	1	1	0
"530908"	"HIL GmbH StPkt Oberviechtach"	"12.999.01.001"	1	1	0
"530946"	"AL-KO Record S.A."	"12.999.01.001"	60	60	0
"530959"	"Hofgut Elbaue"	"12.999.01.001"	1	1	0
"530959"	"Hofgut Elbaue"	"12.999.01.003"	6	6	0
"530959"	"Hofgut Elbaue"	"12.999.01.008"	5	5	0
"530964"	"Peter's Transporte u. Montagen GmbH"	"12.999.01.001"	1	1	0
"530984"	"Weigelt"	"12.999.01.001"	2	2	0
"530984"	"Weigelt"	"12.999.01.003"	1	1	0
"531030"	"Bandis & Knopp GmbH & Co. KG"	"12.999.01.003"	0	50	-50
"531047"	"BASE VIE LGV GUINTOLI"	"12.999.01.003"	1	1	0
"531095"	"Agrargenossenschaft "Moorgrund" e.G"	"12.999.01.003"	1	1	0
"531150"	"KTH Trailer GmbH"	"12.999.01.003"	1	1	0
"90000167"	"Wilhelm Schauerte"	"12.999.01.003"	0	6	-6
"90000187"	"FRAMUER-HALBACH GMBH"	"12.999.01.001"	-1	1	-2
"90000276"	"FORGING PRODUCTS TRADING"	"12.999.01.003"	1	1	0
"90000337"	"Leist Oberflächentechnik e.K."	"12.999.01.003"	1	1	0
"90000337"	"Leist Oberflächentechnik e.K."	"12.999.01.008"	3	3	0
"90000388"	"DOLEZYCH GMBH & CO. KG"	"12.999.01.001"	-2	0	-2
"90000389"	"Schaublin S.A."	"12.999.01.003"	0	0	0
"90000549"	"INTRA Logistik- und"	"12.999.01.003"	1	1	0
