"Kunden Nr."	"Kunde"	"Material Nr."	Anfangsbestand	Retourniert	Zu berechnen
"100001"	"BPW-Fahrzeugtechnik"	"12.999.01.001"	-12	0	-12
"100001"	"BPW-Fahrzeugtechnik"	"12.999.01.003"	27	0	27
"100001"	"BPW-Fahrzeugtechnik"	"12.999.01.008"	2	1	1
"100002"	"M. Busch GmbH & Co. KG"	"12.999.01.001"	-7	12	-19
"100002"	"M. Busch GmbH & Co. KG"	"12.999.01.003"	-45	0	-45
"100002"	"M. Busch GmbH & Co. KG"	"12.999.01.008"	-27	12	-39
"100003"	"F. HESTERBERG & SOEHNE"	"12.999.01.001"	-3	0	-3
"100003"	"F. HESTERBERG & SOEHNE"	"12.999.01.003"	8	0	8
"100003"	"F. HESTERBERG & SOEHNE"	"12.999.01.008"	80	0	80
"100010"	"BPW ITALIA S.R.L."	"12.999.01.001"	182	49	133
"100010"	"BPW ITALIA S.R.L."	"12.999.01.003"	1	79	-78
"100010"	"BPW ITALIA S.R.L."	"12.999.01.008"	-170	4	-174
"100010"	"BPW ITALIA S.R.L."	"12.999.01.188"	239	60	179
"100012"	"BPW LIMITED"	"12.999.01.001"	3	204	-201
"100012"	"BPW LIMITED"	"12.999.01.003"	957	26	931
"100012"	"BPW LIMITED"	"12.999.01.008"	177	60	117
"100012"	"BPW LIMITED"	"12.999.01.162"	2	986	-984
"100012"	"BPW LIMITED"	"12.999.01.163"	441	249	192
"100012"	"BPW LIMITED"	"12.999.01.188"	2	12	-10
"100013"	"BPW ITALIA S.R.L."	"12.999.01.003"	9	9	0
"100014"	"BPW EJES ESPAÑA, S.A."	"12.999.01.188"	6	0	6
"100015"	"FOMA"	"12.999.01.001"	2	0	2
"100015"	"FOMA"	"12.999.01.003"	566	42	524
"100016"	"BPW KRAATZ OY"	"12.999.01.003"	962	59	903
"100016"	"BPW KRAATZ OY"	"12.999.01.008"	5	0	5
"100016"	"BPW KRAATZ OY"	"12.999.01.188"	70	0	70
"100018"	"TRANSPORT-TEKNIK A/S"	"12.999.01.003"	260	13	247
"100020"	"FAHRZEUGBEDARF AG"	"12.999.01.001"	1	0	1
"100020"	"FAHRZEUGBEDARF AG"	"12.999.01.003"	17	0	17
"100020"	"FAHRZEUGBEDARF AG"	"12.999.01.008"	5	0	5
"100021"	"BPW Hofstad A/S"	"12.999.01.003"	2	0	2
"100021"	"BPW Hofstad A/S"	"12.999.01.008"	2	0	2
"100023"	"BPW Polska Sp. z o.o."	"12.999.01.001"	5	3	2
"100023"	"BPW Polska Sp. z o.o."	"12.999.01.003"	15	2	13
"100023"	"BPW Polska Sp. z o.o."	"12.999.01.188"	51	26	25
"100024"	"BPW spol. s.r.o."	"12.999.01.001"	2	0	2
"100024"	"BPW spol. s.r.o."	"12.999.01.003"	2	0	2
"100025"	"BPW-HUNGARIA KFT."	"12.999.01.001"	3	906	-903
"100025"	"BPW-HUNGARIA KFT."	"12.999.01.003"	-661	655	-1316
"100025"	"BPW-HUNGARIA KFT."	"12.999.01.008"	2	455	-453
"100025"	"BPW-HUNGARIA KFT."	"12.999.01.011"	3	0	3
"100025"	"BPW-HUNGARIA KFT."	"12.999.01.162"	2	561	-559
"100025"	"BPW-HUNGARIA KFT."	"12.999.01.163"	265	122	143
"100025"	"BPW-HUNGARIA KFT."	"12.999.01.188"	-55	99	-154
"100029"	"HBN-TEKNIK A/S"	"12.999.01.001"	3	0	3
"100030"	"BPW TRAPACO S.L."	"12.999.01.001"	2	2	0
"100030"	"BPW TRAPACO S.L."	"12.999.01.003"	48	1	47
"100030"	"BPW TRAPACO S.L."	"12.999.01.008"	35	0	35
"100030"	"BPW TRAPACO S.L."	"12.999.01.162"	32	0	32
"100030"	"BPW TRAPACO S.L."	"12.999.01.163"	9	0	9
"100030"	"BPW TRAPACO S.L."	"12.999.01.188"	22	5	17
"100032"	"BPW FRANCE SAS"	"12.999.01.001"	47	27	20
"100032"	"BPW FRANCE SAS"	"12.999.01.003"	437	0	437
"100032"	"BPW FRANCE SAS"	"12.999.01.008"	3	11	-8
"100032"	"BPW FRANCE SAS"	"12.999.01.162"	0	30	-30
"100032"	"BPW FRANCE SAS"	"12.999.01.163"	0	5	-5
"100032"	"BPW FRANCE SAS"	"12.999.01.188"	374	206	168
"100035"	"BPW Benelux sprl."	"12.999.01.001"	838	164	674
"100035"	"BPW Benelux sprl."	"12.999.01.003"	18	77	-59
"100035"	"BPW Benelux sprl."	"12.999.01.008"	164	18	146
"100035"	"BPW Benelux sprl."	"12.999.01.162"	523	22	501
"100035"	"BPW Benelux sprl."	"12.999.01.163"	104	6	98
"100035"	"BPW Benelux sprl."	"12.999.01.165"	6	0	6
"100035"	"BPW Benelux sprl."	"12.999.01.188"	64	161	-97
"100036"	"Busch - Hungaria Kft."	"12.999.01.001"	367	636	-269
"100036"	"Busch - Hungaria Kft."	"12.999.01.003"	-115	0	-115
"100042"	""XL PARTS" SIA"	"12.999.01.003"	0	0	0
"100043"	"Besko A/S"	"12.999.01.003"	151	6	145
"100048"	"Släpis AB"	"12.999.01.001"	0	0	0
"100048"	"Släpis AB"	"12.999.01.003"	30	30	0
"100071"	"BPW AXLES (PTY) LTD."	"12.999.01.003"	1	1	0
"210118"	"ASCHWEGE & TOENJES GMBH"	"12.999.01.001"	3	2	1
"210118"	"ASCHWEGE & TOENJES GMBH"	"12.999.01.162"	6	0	6
"210118"	"ASCHWEGE & TOENJES GMBH"	"12.999.01.163"	2	0	2
"210118"	"ASCHWEGE & TOENJES GMBH"	"12.999.01.188"	1	0	1
"210234"	"LUDWIG BERGMANN GMBH"	"12.999.01.001"	2	1	1
"210235"	"BRIRI GMBH"	"12.999.01.003"	0	0	0
"210247"	"Blomenröhr Fahrzeugbau GmbH"	"12.999.01.001"	2	2	0
"210247"	"Blomenröhr Fahrzeugbau GmbH"	"12.999.01.003"	8	8	0
"210250"	"Bagela Baumaschinen GmbH & Co.KG"	"12.999.01.001"	0	0	0
"210305"	"Carnehl Fahrzeugbau"	"12.999.01.001"	44	3	41
"210305"	"Carnehl Fahrzeugbau"	"12.999.01.003"	10	9	1
"210305"	"Carnehl Fahrzeugbau"	"12.999.01.008"	9	0	9
"210305"	"Carnehl Fahrzeugbau"	"12.999.01.162"	44	0	44
"210305"	"Carnehl Fahrzeugbau"	"12.999.01.163"	11	0	11
"210305"	"Carnehl Fahrzeugbau"	"12.999.01.188"	21	2	19
"210507"	"EGGERS"	"12.999.01.001"	2	2	0
"210507"	"EGGERS"	"12.999.01.003"	0	0	0
"210507"	"EGGERS"	"12.999.01.008"	2	2	0
"210507"	"EGGERS"	"12.999.01.162"	8	8	0
"210507"	"EGGERS"	"12.999.01.163"	2	2	0
"210602"	"FELDBINDER"	"12.999.01.001"	71	8	63
"210602"	"FELDBINDER"	"12.999.01.003"	-17	0	-17
"210602"	"FELDBINDER"	"12.999.01.008"	-7	3	-10
"210602"	"FELDBINDER"	"12.999.01.162"	11	4	7
"210602"	"FELDBINDER"	"12.999.01.163"	3	1	2
"210602"	"FELDBINDER"	"12.999.01.188"	74	22	52
"210613"	"WILHELM FRICKE GMBH"	"12.999.01.001"	4	4	0
"210613"	"WILHELM FRICKE GMBH"	"12.999.01.003"	3	3	0
"210613"	"WILHELM FRICKE GMBH"	"12.999.01.008"	2	0	2
"210818"	"Hofmeister & Meincke GmbH & Co. KG"	"12.999.01.001"	12	5	7
"210818"	"Hofmeister & Meincke GmbH & Co. KG"	"12.999.01.003"	-57	3	-60
"210818"	"Hofmeister & Meincke GmbH & Co. KG"	"12.999.01.008"	0	0	0
"210833"	"A.-W. HEIL & SOHN GMBH & CO.KG"	"12.999.01.001"	1	0	1
"210845"	"HEINRICH HEUSER GMBH & CO. KG"	"12.999.01.001"	0	0	0
"210846"	"Heitling Fahrzeugbau GmbH & Co. KG"	"12.999.01.001"	2	0	2
"210846"	"Heitling Fahrzeugbau GmbH & Co. KG"	"12.999.01.188"	1	0	1
"210849"	"HRD-TRAILER-ENGINEERING GMBH"	"12.999.01.001"	26	19	7
"210849"	"HRD-TRAILER-ENGINEERING GMBH"	"12.999.01.003"	5	2	3
"210849"	"HRD-TRAILER-ENGINEERING GMBH"	"12.999.01.008"	9	6	3
"210849"	"HRD-TRAILER-ENGINEERING GMBH"	"12.999.01.162"	20	6	14
"210849"	"HRD-TRAILER-ENGINEERING GMBH"	"12.999.01.163"	13	8	5
"210849"	"HRD-TRAILER-ENGINEERING GMBH"	"12.999.01.188"	5	0	5
"211005"	"OTTO JUST GMBH & CO. KG"	"12.999.01.001"	0	0	0
"211108"	"Köhler Fahrzeugbau GmbH & Co.KG"	"12.999.01.001"	2	0	2
"211108"	"Köhler Fahrzeugbau GmbH & Co.KG"	"12.999.01.003"	1	0	1
"211108"	"Köhler Fahrzeugbau GmbH & Co.KG"	"12.999.01.188"	1	0	1
"211122"	"EMMY KLOOSS"	"12.999.01.001"	0	3	-3
"211123"	"PETER KROEGER GMBH"	"12.999.01.001"	0	0	0
"211130"	"Josef Kotte"	"12.999.01.001"	2	1	1
"211130"	"Josef Kotte"	"12.999.01.003"	1	0	1
"211133"	"KRUKENMEIER GMBH"	"12.999.01.001"	5	3	2
"211133"	"KRUKENMEIER GMBH"	"12.999.01.003"	4	3	1
"211133"	"KRUKENMEIER GMBH"	"12.999.01.162"	4	0	4
"211133"	"KRUKENMEIER GMBH"	"12.999.01.163"	1	0	1
"211133"	"KRUKENMEIER GMBH"	"12.999.01.188"	1	0	1
"211134"	"KAR KUNZ"	"12.999.01.001"	-4	0	-4
"211134"	"KAR KUNZ"	"12.999.01.003"	2	0	2
"211136"	"Kedrowski Fahrzeugbau GmbH & Co. KG"	"12.999.01.001"	0	0	0
"211136"	"Kedrowski Fahrzeugbau GmbH & Co. KG"	"12.999.01.003"	0	0	0
"211214"	"LAHRS GmbH & Co. KG"	"12.999.01.003"	1	0	1
"211214"	"LAHRS GmbH & Co. KG"	"12.999.01.188"	1	0	1
"211325"	"MENKE-JANZEN"	"12.999.01.001"	41	5	36
"211325"	"MENKE-JANZEN"	"12.999.01.003"	-2	1	-3
"211325"	"MENKE-JANZEN"	"12.999.01.162"	2	0	2
"211325"	"MENKE-JANZEN"	"12.999.01.163"	1	0	1
"211325"	"MENKE-JANZEN"	"12.999.01.188"	6	4	2
"211327"	"Moetefindt Fahrzeugbau"	"12.999.01.001"	1	1	0
"211327"	"Moetefindt Fahrzeugbau"	"12.999.01.003"	2	2	0
"211330"	"MEYER - LOHNE GMBH"	"12.999.01.001"	0	0	0
"211613"	"PV Automotive GmbH"	"12.999.01.001"	0	0	0
"211613"	"PV Automotive GmbH"	"12.999.01.003"	0	0	0
"211813"	"Reiling Nutzfahrzeugservice GmbH"	"12.999.01.001"	0	0	0
"211906"	"SPIER  GMBH & CO."	"12.999.01.001"	12	1	11
"211906"	"SPIER  GMBH & CO."	"12.999.01.003"	12	1	11
"211906"	"SPIER  GMBH & CO."	"12.999.01.008"	12	0	12
"211906"	"SPIER  GMBH & CO."	"12.999.01.162"	32	0	32
"211906"	"SPIER  GMBH & CO."	"12.999.01.163"	8	0	8
"211906"	"SPIER  GMBH & CO."	"12.999.01.188"	2	0	2
"211912"	"Ludwig Südbeck Nutzfahrzeuge GmbH"	"12.999.01.001"	0	0	0
"211915"	"JUERGEN STERN"	"12.999.01.001"	0	0	0
"212004"	"SCHROEDER"	"12.999.01.001"	3	0	3
"212004"	"SCHROEDER"	"12.999.01.003"	3	0	3
"212004"	"SCHROEDER"	"12.999.01.162"	2	0	2
"212004"	"SCHROEDER"	"12.999.01.163"	1	0	1
"212004"	"SCHROEDER"	"12.999.01.188"	1	0	1
"212010"	"SCHUETTE FAHRZEUGBAU GMBH"	"12.999.01.001"	1	1	0
"212010"	"SCHUETTE FAHRZEUGBAU GMBH"	"12.999.01.003"	1	1	0
"212012"	"KFB Jessen GmbH"	"12.999.01.001"	2	0	2
"212012"	"KFB Jessen GmbH"	"12.999.01.003"	2	0	2
"212020"	"E. SCHWAGMEIER KAROSSERIE- UND"	"12.999.01.001"	1	0	1
"212020"	"E. SCHWAGMEIER KAROSSERIE- UND"	"12.999.01.003"	1	0	1
"212109"	"Stehmann GmbH"	"12.999.01.001"	8	0	8
"212109"	"Stehmann GmbH"	"12.999.01.003"	6	0	6
"212109"	"Stehmann GmbH"	"12.999.01.188"	2	0	2
"212110"	"METALLBAU STAGGENBORG GMBH"	"12.999.01.001"	-5	0	-5
"212110"	"METALLBAU STAGGENBORG GMBH"	"12.999.01.003"	2	0	2
"212209"	"HERMANN TECHAU"	"12.999.01.001"	0	0	0
"212213"	"TOS TWIST"	"12.999.01.001"	1	1	0
"212215"	"Jacob Thaler GmbH"	"12.999.01.001"	2	0	2
"212504"	"Lely Vermeer"	"12.999.01.003"	1	0	1
"212504"	"Lely Vermeer"	"12.999.01.008"	2	0	2
"212508"	"WABCO GmbH & Co. OHG"	"12.999.01.001"	-9	0	-9
"212527"	"Wiese GmbH & Co. KG"	"12.999.01.001"	2	1	1
"212527"	"Wiese GmbH & Co. KG"	"12.999.01.003"	1	1	0
"212527"	"Wiese GmbH & Co. KG"	"12.999.01.188"	3	0	3
"212528"	"WILKEN"	"12.999.01.188"	6	4	2
"212534"	"Heinrich Wellmeyer Fahrzeugbau"	"12.999.01.001"	9	3	6
"212534"	"Heinrich Wellmeyer Fahrzeugbau"	"12.999.01.003"	0	0	0
"212534"	"Heinrich Wellmeyer Fahrzeugbau"	"12.999.01.162"	4	0	4
"212534"	"Heinrich Wellmeyer Fahrzeugbau"	"12.999.01.163"	1	0	1
"212534"	"Heinrich Wellmeyer Fahrzeugbau"	"12.999.01.188"	10	2	8
"212535"	"Weka Fahrzeugbau GmbH"	"12.999.01.001"	45	2	43
"212535"	"Weka Fahrzeugbau GmbH"	"12.999.01.003"	1	1	0
"212535"	"Weka Fahrzeugbau GmbH"	"12.999.01.008"	1	0	1
"212535"	"Weka Fahrzeugbau GmbH"	"12.999.01.162"	4	0	4
"212535"	"Weka Fahrzeugbau GmbH"	"12.999.01.163"	1	0	1
"212535"	"Weka Fahrzeugbau GmbH"	"12.999.01.188"	13	2	11
"220116"	"ATV-ELMER GMBH & CO. KG"	"12.999.01.001"	2	0	2
"220116"	"ATV-ELMER GMBH & CO. KG"	"12.999.01.003"	2	0	2
"220118"	"AMAZONEN-WERKE"	"12.999.01.001"	10	0	10
"220118"	"AMAZONEN-WERKE"	"12.999.01.003"	4	1	3
"220118"	"AMAZONEN-WERKE"	"12.999.01.008"	3	0	3
"220204"	"Bierhake Fahrzeugteile"	"12.999.01.001"	0	1	-1
"220205"	"Bierhake Fahrzeugteile"	"12.999.01.001"	0	3	-3
"220210"	"BOECKER Maschinenwerke GmbH"	"12.999.01.001"	0	0	0
"220228"	"Bohnenkamp AG"	"12.999.01.001"	5	0	5
"220252"	"PAUL BRUESER GMBH"	"12.999.01.001"	-16	0	-16
"220252"	"PAUL BRUESER GMBH"	"12.999.01.003"	12	28	-16
"220252"	"PAUL BRUESER GMBH"	"12.999.01.008"	570	150	420
"220252"	"PAUL BRUESER GMBH"	"12.999.01.011"	3	0	3
"220254"	"BWO BEHINDERTEN-WERKSTAETTEN"	"12.999.01.001"	-21	25	-46
"220254"	"BWO BEHINDERTEN-WERKSTAETTEN"	"12.999.01.003"	97	15	82
"220254"	"BWO BEHINDERTEN-WERKSTAETTEN"	"12.999.01.008"	58	51	7
"220255"	"BWO BEHINDERTEN-WERSTAETTEN"	"12.999.01.001"	-13	104	-117
"220255"	"BWO BEHINDERTEN-WERSTAETTEN"	"12.999.01.003"	11	53	-42
"220255"	"BWO BEHINDERTEN-WERSTAETTEN"	"12.999.01.008"	52	48	4
"220312"	"MANNSTAEDT GMBH & CO. KG"	"12.999.01.001"	7	4	3
"220312"	"MANNSTAEDT GMBH & CO. KG"	"12.999.01.003"	2	0	2
"220414"	"FAHRZEUGBAU DRUMANN GMBH"	"12.999.01.001"	0	0	0
"220414"	"FAHRZEUGBAU DRUMANN GMBH"	"12.999.01.003"	0	0	0
"220523"	"EUROPART  Trading GmbH"	"12.999.01.001"	0	1	-1
"220628"	"FONTANA GMBH"	"12.999.01.003"	-279	0	-279
"220628"	"FONTANA GMBH"	"12.999.01.008"	594	0	594
"220629"	"GEORG FISCHER GMBH & CO. KG"	"12.999.01.001"	-1	0	-1
"220629"	"GEORG FISCHER GMBH & CO. KG"	"12.999.01.003"	-7	0	-7
"220703"	"GOFA Gocher Fahrzeugbau GmbH"	"12.999.01.001"	18	0	18
"220703"	"GOFA Gocher Fahrzeugbau GmbH"	"12.999.01.003"	4	0	4
"220703"	"GOFA Gocher Fahrzeugbau GmbH"	"12.999.01.008"	1	0	1
"220703"	"GOFA Gocher Fahrzeugbau GmbH"	"12.999.01.162"	4	0	4
"220703"	"GOFA Gocher Fahrzeugbau GmbH"	"12.999.01.188"	14	6	8
"220814"	"Beilharz Nutzfahrzeuge"	"12.999.01.001"	2	0	2
"220814"	"Beilharz Nutzfahrzeuge"	"12.999.01.003"	1	0	1
"220843"	"HEETMANN & FINKENSIEP"	"12.999.01.003"	-10	30	-40
"220843"	"HEETMANN & FINKENSIEP"	"12.999.01.008"	98	80	18
"221113"	"Fahrzeugwerk Bernard Krone GmbH"	"12.999.01.001"	996	383	613
"221113"	"Fahrzeugwerk Bernard Krone GmbH"	"12.999.01.003"	9	12	-3
"221113"	"Fahrzeugwerk Bernard Krone GmbH"	"12.999.01.008"	21	44	-23
"221113"	"Fahrzeugwerk Bernard Krone GmbH"	"12.999.01.162"	304	282	22
"221113"	"Fahrzeugwerk Bernard Krone GmbH"	"12.999.01.163"	87	77	10
"221113"	"Fahrzeugwerk Bernard Krone GmbH"	"12.999.01.188"	437	781	-344
"221114"	"KLAESER INTERN. FACHSPEDITION"	"12.999.01.001"	4	0	4
"221114"	"KLAESER INTERN. FACHSPEDITION"	"12.999.01.003"	6	0	6
"221114"	"KLAESER INTERN. FACHSPEDITION"	"12.999.01.188"	2	0	2
"221126"	"Kroll Fahrzeugbau-"	"12.999.01.001"	1	0	1
"221126"	"Kroll Fahrzeugbau-"	"12.999.01.003"	1	0	1
"221126"	"Kroll Fahrzeugbau-"	"12.999.01.188"	0	0	0
"221155"	"KRAMPE"	"12.999.01.001"	0	0	0
"221155"	"KRAMPE"	"12.999.01.003"	0	0	0
"221207"	"LEVEN NUTZFAHRZEUGE"	"12.999.01.001"	0	1	-1
"221207"	"LEVEN NUTZFAHRZEUGE"	"12.999.01.003"	0	0	0
"221213"	"Hermann Langfeld e.K."	"12.999.01.001"	3	0	3
"221213"	"Hermann Langfeld e.K."	"12.999.01.003"	0	0	0
"221213"	"Hermann Langfeld e.K."	"12.999.01.188"	3	0	3
"221214"	"LOECHTERFELD GMBH"	"12.999.01.001"	1	1	0
"221214"	"LOECHTERFELD GMBH"	"12.999.01.003"	0	0	0
"221221"	"LANCIER CABLE GMBH"	"12.999.01.001"	0	0	0
"221229"	"LEMKEN GMBH & CO. KG"	"12.999.01.001"	1	0	1
"221229"	"LEMKEN GMBH & CO. KG"	"12.999.01.008"	5	0	5
"221233"	"LANGENDORF GmbH"	"12.999.01.001"	201	53	148
"221233"	"LANGENDORF GmbH"	"12.999.01.003"	2	8	-6
"221233"	"LANGENDORF GmbH"	"12.999.01.008"	36	19	17
"221233"	"LANGENDORF GmbH"	"12.999.01.162"	2	8	-6
"221233"	"LANGENDORF GmbH"	"12.999.01.163"	4	2	2
"221233"	"LANGENDORF GmbH"	"12.999.01.188"	43	17	26
"221309"	"ANHAENGER- U. FAHRZEUGBAU"	"12.999.01.001"	2	0	2
"221309"	"ANHAENGER- U. FAHRZEUGBAU"	"12.999.01.008"	1	0	1
"221309"	"ANHAENGER- U. FAHRZEUGBAU"	"12.999.01.188"	1	0	1
"221404"	"NTV NUTZFAHRZEUGTEILE"	"12.999.01.001"	15	9	6
"221404"	"NTV NUTZFAHRZEUGTEILE"	"12.999.01.003"	2	1	1
"221506"	"OSTERATH GMBH"	"12.999.01.001"	1	0	1
"221506"	"OSTERATH GMBH"	"12.999.01.003"	2	0	2
"221506"	"OSTERATH GMBH"	"12.999.01.188"	0	0	0
"221609"	"PV Automotive GmbH"	"12.999.01.003"	1	0	1
"221610"	"PV Automotive GmbH"	"12.999.01.001"	26	15	11
"221610"	"PV Automotive GmbH"	"12.999.01.003"	5	3	2
"221610"	"PV Automotive GmbH"	"12.999.01.008"	0	0	0
"221613"	"PV Automotive GmbH"	"12.999.01.003"	0	0	0
"221806"	"Fahrzeugbau Robert GmbH"	"12.999.01.001"	1	1	0
"221813"	"GEBR. RECKER GMBH"	"12.999.01.001"	2	0	2
"221813"	"GEBR. RECKER GMBH"	"12.999.01.162"	4	0	4
"221813"	"GEBR. RECKER GMBH"	"12.999.01.163"	1	0	1
"221815"	"RI-FA"	"12.999.01.001"	0	0	0
"221815"	"RI-FA"	"12.999.01.003"	0	0	0
"221907"	"SUER NUTZFAHRZEUGTECHNIK Gmbh & Co"	"12.999.01.001"	0	0	0
"221921"	"SIEPMANN-WERKE"	"12.999.01.001"	-1	0	-1
"222002"	"August Schmidt GmbH & Co. KG"	"12.999.01.001"	16	2	14
"222002"	"August Schmidt GmbH & Co. KG"	"12.999.01.003"	7	1	6
"222002"	"August Schmidt GmbH & Co. KG"	"12.999.01.008"	2	0	2
"222002"	"August Schmidt GmbH & Co. KG"	"12.999.01.188"	13	2	11
"222016"	"FORTUNA FAHRZEUGBAU GMBH & CO. KG"	"12.999.01.003"	0	0	0
"222019"	"SCHMIDT KRAFTFAHRZEUG-"	"12.999.01.001"	3	4	-1
"222019"	"SCHMIDT KRAFTFAHRZEUG-"	"12.999.01.003"	0	0	0
"222027"	"WILLI SCHOLZ GMBH & CO. KG"	"12.999.01.003"	1	0	1
"222030"	"SCHMITZ-CARGOBULL AG"	"12.999.01.001"	8	4	4
"222030"	"SCHMITZ-CARGOBULL AG"	"12.999.01.003"	-16	0	-16
"222030"	"SCHMITZ-CARGOBULL AG"	"12.999.01.188"	22	12	10
"222032"	"SCHMITZ-CARGOBULL AG"	"12.999.01.001"	-2	7	-9
"222032"	"SCHMITZ-CARGOBULL AG"	"12.999.01.003"	-4	0	-4
"222032"	"SCHMITZ-CARGOBULL AG"	"12.999.01.008"	1	0	1
"222032"	"SCHMITZ-CARGOBULL AG"	"12.999.01.188"	82	27	55
"222037"	"SCHRADER-T + A + Fahrzeugbau"	"12.999.01.001"	2	0	2
"222037"	"SCHRADER-T + A + Fahrzeugbau"	"12.999.01.008"	1	0	1
"222037"	"SCHRADER-T + A + Fahrzeugbau"	"12.999.01.188"	10	0	10
"222042"	"SCHMIEDAG GMBH"	"12.999.01.001"	11	0	11
"222107"	"STAPEL GMBH"	"12.999.01.001"	1	1	0
"222203"	"KARL TANG GMBH"	"12.999.01.001"	0	0	0
"222203"	"KARL TANG GMBH"	"12.999.01.003"	0	0	0
"222204"	"GEBR. TITGEMEYER GMBH & CO. KG"	"12.999.01.001"	0	0	0
"222204"	"GEBR. TITGEMEYER GMBH & CO. KG"	"12.999.01.003"	0	0	0
"222216"	"Albert Tebbe GmbH"	"12.999.01.001"	3	0	3
"222216"	"Albert Tebbe GmbH"	"12.999.01.003"	2	0	2
"222540"	"WINKLER FAHRZEUGTEILE GMBH"	"12.999.01.001"	1	0	1
"222543"	"WECON"	"12.999.01.001"	31	2	29
"222543"	"WECON"	"12.999.01.003"	37	5	32
"222543"	"WECON"	"12.999.01.008"	5	0	5
"222543"	"WECON"	"12.999.01.162"	2	0	2
"222543"	"WECON"	"12.999.01.165"	2	0	2
"222543"	"WECON"	"12.999.01.188"	10	0	10
"222547"	"W+O NIETTECHNIK GMBH"	"12.999.01.001"	1	0	1
"222547"	"W+O NIETTECHNIK GMBH"	"12.999.01.003"	99	0	99
"222547"	"W+O NIETTECHNIK GMBH"	"12.999.01.008"	252	0	252
"223001"	"SCHOMAECKER FEDERNWERK GMBH"	"12.999.01.001"	71	0	71
"223001"	"SCHOMAECKER FEDERNWERK GMBH"	"12.999.01.003"	-710	0	-710
"223008"	"Rütgers GmbH & Co. KG"	"12.999.01.001"	2	0	2
"223008"	"Rütgers GmbH & Co. KG"	"12.999.01.003"	12	0	12
"223017"	"WESTFALEN AG"	"12.999.01.003"	0	0	0
"230000"	"BPW Bergische Achsen"	"12.999.01.001"	19	0	19
"230000"	"BPW Bergische Achsen"	"12.999.01.003"	45	4	41
"230000"	"BPW Bergische Achsen"	"12.999.01.008"	5	1	4
"240213"	"BERGER KAROSSERIE-"	"12.999.01.001"	0	0	0
"240213"	"BERGER KAROSSERIE-"	"12.999.01.003"	0	0	0
"240240"	"Benninghoven GmbH & Co KG"	"12.999.01.003"	5	0	5
"240505"	"DR. ING. ULRICH ESTERER GMBH & CO."	"12.999.01.001"	0	0	0
"240505"	"DR. ING. ULRICH ESTERER GMBH & CO."	"12.999.01.003"	0	0	0
"240518"	"EUROPART"	"12.999.01.001"	1	0	1
"240520"	"EUROPART  Trading GMBH"	"12.999.01.001"	1	0	1
"240522"	"EISEL NUTZFAHRZEUGE GMBH"	"12.999.01.001"	4	0	4
"240522"	"EISEL NUTZFAHRZEUGE GMBH"	"12.999.01.003"	2	0	2
"240522"	"EISEL NUTZFAHRZEUGE GMBH"	"12.999.01.188"	2	0	2
"240632"	"Fischer Fahrzeugbau GmbH"	"12.999.01.001"	1	0	1
"240733"	"GANGOLF NUTZFAHRZEUGE GMBH"	"12.999.01.001"	2	0	2
"240827"	"HEURICH"	"12.999.01.001"	1	0	1
"240827"	"HEURICH"	"12.999.01.003"	2	0	2
"240836"	"HAGE, KNAPP & CO."	"12.999.01.001"	3	2	1
"240836"	"HAGE, KNAPP & CO."	"12.999.01.003"	1	1	0
"240836"	"HAGE, KNAPP & CO."	"12.999.01.188"	1	0	1
"241008"	"Jost  Werke GmbH"	"12.999.01.001"	-108	0	-108
"241008"	"Jost  Werke GmbH"	"12.999.01.003"	-1	0	-1
"241114"	"ERICH KERSTING GMBH & CO. KG"	"12.999.01.001"	2	0	2
"241114"	"ERICH KERSTING GMBH & CO. KG"	"12.999.01.003"	2	0	2
"241134"	"Fahrzeugbau Kempf GmbH"	"12.999.01.001"	82	25	57
"241134"	"Fahrzeugbau Kempf GmbH"	"12.999.01.003"	-1	0	-1
"241134"	"Fahrzeugbau Kempf GmbH"	"12.999.01.008"	2	1	1
"241134"	"Fahrzeugbau Kempf GmbH"	"12.999.01.162"	16	0	16
"241134"	"Fahrzeugbau Kempf GmbH"	"12.999.01.163"	4	0	4
"241134"	"Fahrzeugbau Kempf GmbH"	"12.999.01.188"	92	26	66
"241146"	"KEMPF FAHRZEUGBAU"	"12.999.01.001"	2	0	2
"241146"	"KEMPF FAHRZEUGBAU"	"12.999.01.188"	3	0	3
"241214"	"LUECK FAHRZEUGBAU GMBH"	"12.999.01.001"	3	0	3
"241214"	"LUECK FAHRZEUGBAU GMBH"	"12.999.01.003"	1	0	1
"241214"	"LUECK FAHRZEUGBAU GMBH"	"12.999.01.188"	3	0	3
"241216"	"LEISE GMBH & CO. KG"	"12.999.01.001"	2	6	-4
"241216"	"LEISE GMBH & CO. KG"	"12.999.01.003"	0	0	0
"241217"	"KRAMP Groep B.V."	"12.999.01.001"	3	0	3
"241217"	"KRAMP Groep B.V."	"12.999.01.008"	0	0	0
"241328"	"A. MUELLER FAHRZEUGBAU GMBH"	"12.999.01.001"	5	2	3
"241328"	"A. MUELLER FAHRZEUGBAU GMBH"	"12.999.01.003"	3	2	1
"241328"	"A. MUELLER FAHRZEUGBAU GMBH"	"12.999.01.188"	2	0	2
"241349"	"F. MUELLER GMBH & CO. KG"	"12.999.01.001"	0	0	0
"241349"	"F. MUELLER GMBH & CO. KG"	"12.999.01.003"	3	0	3
"241349"	"F. MUELLER GMBH & CO. KG"	"12.999.01.188"	0	0	0
"241350"	"MENZER GMBH"	"12.999.01.001"	0	0	0
"241505"	"ORTEN GMBH & CO. KG"	"12.999.01.001"	0	0	0
"241505"	"ORTEN GMBH & CO. KG"	"12.999.01.003"	0	0	0
"241618"	"PROFI PARTS"	"12.999.01.001"	101	2	99
"241618"	"PROFI PARTS"	"12.999.01.003"	-8	0	-8
"241619"	"PROFI PARTS"	"12.999.01.001"	5	1	4
"241619"	"PROFI PARTS"	"12.999.01.003"	0	0	0
"241620"	"PROFI PARTS"	"12.999.01.001"	0	0	0
"241829"	"ROETTGER"	"12.999.01.001"	1	0	1
"241829"	"ROETTGER"	"12.999.01.003"	1	0	1
"241840"	"Dieter Röttger"	"12.999.01.001"	0	0	0
"241840"	"Dieter Röttger"	"12.999.01.003"	0	0	0
"241841"	"Winkler Logistik GmbH"	"12.999.01.001"	0	0	0
"241841"	"Winkler Logistik GmbH"	"12.999.01.003"	0	0	0
"242506"	"EUROPART  Trading GMBH"	"12.999.01.001"	0	0	0
"242516"	"WELLER GMBH & CO. KG"	"12.999.01.001"	0	0	0
"242516"	"WELLER GMBH & CO. KG"	"12.999.01.003"	1	0	1
"242516"	"WELLER GMBH & CO. KG"	"12.999.01.008"	0	0	0
"242520"	"HEINRICH WEDEKIND &"	"12.999.01.001"	0	0	0
"242520"	"HEINRICH WEDEKIND &"	"12.999.01.003"	0	0	0
"250212"	"BIRNER GMBH"	"12.999.01.001"	1	0	1
"250213"	"BISCHOFF + SCHECK AG"	"12.999.01.001"	1	1	0
"250213"	"BISCHOFF + SCHECK AG"	"12.999.01.003"	0	0	0
"250409"	"DIER & JAKOB"	"12.999.01.001"	0	0	0
"250611"	"FGS GMBH"	"12.999.01.001"	0	0	0
"250702"	"GOMM FAHRZEUGBAU GMBH"	"12.999.01.001"	0	0	0
"250702"	"GOMM FAHRZEUGBAU GMBH"	"12.999.01.003"	0	0	0
"250807"	"HONOLD GMBH & CO.KG"	"12.999.01.001"	1	0	1
"250807"	"HONOLD GMBH & CO.KG"	"12.999.01.188"	2	0	2
"250822"	"HIRTH FAHRZEUGBAU GMBH"	"12.999.01.001"	1	0	1
"251113"	"KAROSSERIEFABRIK BIBERACH GMBH"	"12.999.01.001"	4	2	2
"251113"	"KAROSSERIEFABRIK BIBERACH GMBH"	"12.999.01.188"	1	0	1
"251114"	"KOEPF FAHRZEUGBAU GMBH"	"12.999.01.188"	0	0	0
"251121"	"MASCHINENBAU KALTENBACH GMBH"	"12.999.01.001"	0	0	0
"251121"	"MASCHINENBAU KALTENBACH GMBH"	"12.999.01.003"	1	1	0
"251121"	"MASCHINENBAU KALTENBACH GMBH"	"12.999.01.188"	0	0	0
"251132"	"KAMAG"	"12.999.01.001"	0	0	0
"251132"	"KAMAG"	"12.999.01.003"	0	0	0
"251203"	"LIEBHERR-WERK"	"12.999.01.001"	5	0	5
"251203"	"LIEBHERR-WERK"	"12.999.01.003"	16	0	16
"251203"	"LIEBHERR-WERK"	"12.999.01.008"	1	0	1
"251203"	"LIEBHERR-WERK"	"12.999.01.163"	1	0	1
"251208"	"L + M FAHRZEUGBAU GMBH"	"12.999.01.001"	3	1	2
"251208"	"L + M FAHRZEUGBAU GMBH"	"12.999.01.003"	1	1	0
"251208"	"L + M FAHRZEUGBAU GMBH"	"12.999.01.162"	2	0	2
"251208"	"L + M FAHRZEUGBAU GMBH"	"12.999.01.163"	1	0	1
"251306"	"Karl Mueller GmbH & Co. KG"	"12.999.01.001"	15	15	0
"251306"	"Karl Mueller GmbH & Co. KG"	"12.999.01.003"	9	9	0
"251306"	"Karl Mueller GmbH & Co. KG"	"12.999.01.008"	5	5	0
"251306"	"Karl Mueller GmbH & Co. KG"	"12.999.01.162"	14	14	0
"251306"	"Karl Mueller GmbH & Co. KG"	"12.999.01.163"	5	5	0
"251306"	"Karl Mueller GmbH & Co. KG"	"12.999.01.188"	0	0	0
"251317"	"MS-PARTS GMBH"	"12.999.01.001"	4	1	3
"251317"	"MS-PARTS GMBH"	"12.999.01.003"	10	1	9
"251317"	"MS-PARTS GMBH"	"12.999.01.188"	2	0	2
"251405"	"Neumayer Tekfor GmbH"	"12.999.01.001"	18	0	18
"251405"	"Neumayer Tekfor GmbH"	"12.999.01.003"	91	0	91
"251405"	"Neumayer Tekfor GmbH"	"12.999.01.008"	198	0	198
"251805"	"Winkler Logistik GmbH"	"12.999.01.001"	14	0	14
"251812"	"Winkler Logistik GmbH"	"12.999.01.001"	201	21	180
"251812"	"Winkler Logistik GmbH"	"12.999.01.003"	49	6	43
"251812"	"Winkler Logistik GmbH"	"12.999.01.008"	1	0	1
"251904"	"SPITZER"	"12.999.01.001"	11	6	5
"251904"	"SPITZER"	"12.999.01.003"	14	0	14
"251904"	"SPITZER"	"12.999.01.162"	4	0	4
"251904"	"SPITZER"	"12.999.01.163"	1	0	1
"251904"	"SPITZER"	"12.999.01.188"	59	15	44
"252018"	"SCHEUERLE"	"12.999.01.001"	3	1	2
"252018"	"SCHEUERLE"	"12.999.01.003"	20	9	11
"252020"	"SCHAEFER-TECHNIC GMBH"	"12.999.01.001"	0	0	0
"252020"	"SCHAEFER-TECHNIC GMBH"	"12.999.01.003"	0	0	0
"252029"	"AEBI SCHMIDT DEUTSCHLAND GMBH"	"12.999.01.001"	16	1	15
"252029"	"AEBI SCHMIDT DEUTSCHLAND GMBH"	"12.999.01.003"	50	0	50
"252029"	"AEBI SCHMIDT DEUTSCHLAND GMBH"	"12.999.01.008"	1	0	1
"252030"	"Fahrzeugbau Hahn e. K"	"12.999.01.003"	1	1	0
"252107"	"STAIGER NUTZFAHRZEUGE GMBH"	"12.999.01.001"	1	0	1
"252110"	"AUTOTEILE STREB GMBH"	"12.999.01.001"	0	0	0
"252110"	"AUTOTEILE STREB GMBH"	"12.999.01.003"	0	0	0
"252204"	"TROST AUTO SERVICE TECHNIK SE"	"12.999.01.001"	0	0	0
"252403"	"VETTER GMBH"	"12.999.01.001"	0	0	0
"252508"	"WINKLER FAHRZEUGTEILE GMBH"	"12.999.01.001"	2	2	0
"252509"	"WINKLER Fahrzeugteile GmbH & Co.KG"	"12.999.01.001"	2	2	0
"252509"	"WINKLER Fahrzeugteile GmbH & Co.KG"	"12.999.01.003"	1	1	0
"252522"	"J. WILLIBALD"	"12.999.01.001"	1	0	1
"252522"	"J. WILLIBALD"	"12.999.01.003"	0	0	0
"252522"	"J. WILLIBALD"	"12.999.01.008"	0	0	0
"252524"	"WINKLER FAHRZEUGTECHNIK GMBH"	"12.999.01.003"	0	0	0
"252702"	"ZIKUN FAHRZEUGBAU GMBH"	"12.999.01.001"	0	0	0
"252702"	"ZIKUN FAHRZEUGBAU GMBH"	"12.999.01.003"	7	3	4
"252702"	"ZIKUN FAHRZEUGBAU GMBH"	"12.999.01.188"	11	0	11
"252704"	"GUSTAV ZIEGLER GMBH"	"12.999.01.001"	4	0	4
"252704"	"GUSTAV ZIEGLER GMBH"	"12.999.01.003"	2	1	1
"252704"	"GUSTAV ZIEGLER GMBH"	"12.999.01.162"	6	0	6
"252704"	"GUSTAV ZIEGLER GMBH"	"12.999.01.163"	2	0	2
"253010"	"MARTIN KNIRSCH"	"12.999.01.003"	0	0	0
"253032"	"KLUMPP & MUELLER GMBH & CO. KG"	"12.999.01.001"	1	0	1
"253032"	"KLUMPP & MUELLER GMBH & CO. KG"	"12.999.01.003"	1	0	1
"260216"	"BNT GMBH"	"12.999.01.001"	1	1	0
"260217"	"T. BRANDL GMBH & CO. KG"	"12.999.01.001"	0	0	0
"260217"	"T. BRANDL GMBH & CO. KG"	"12.999.01.003"	0	0	0
"260405"	"JOHANN DEMMLER KG"	"12.999.01.001"	3	2	1
"260405"	"JOHANN DEMMLER KG"	"12.999.01.003"	12	2	10
"260405"	"JOHANN DEMMLER KG"	"12.999.01.008"	0	0	0
"260502"	"ECKART Maschinenbau GmbH"	"12.999.01.001"	0	0	0
"260604"	"JOSEF FINKL KG"	"12.999.01.001"	0	6	-6
"260613"	"FLIEGL FAHRZEUGBAU GMBH"	"12.999.01.001"	258	37	221
"260613"	"FLIEGL FAHRZEUGBAU GMBH"	"12.999.01.003"	97	17	80
"260613"	"FLIEGL FAHRZEUGBAU GMBH"	"12.999.01.008"	38	4	34
"260613"	"FLIEGL FAHRZEUGBAU GMBH"	"12.999.01.162"	-2	0	-2
"260613"	"FLIEGL FAHRZEUGBAU GMBH"	"12.999.01.163"	-4	0	-4
"260613"	"FLIEGL FAHRZEUGBAU GMBH"	"12.999.01.165"	8	0	8
"260613"	"FLIEGL FAHRZEUGBAU GMBH"	"12.999.01.188"	138	46	92
"260618"	"FLIEGL Agrartechnik GmbH"	"12.999.01.001"	1	0	1
"260618"	"FLIEGL Agrartechnik GmbH"	"12.999.01.003"	0	0	0
"260618"	"FLIEGL Agrartechnik GmbH"	"12.999.01.008"	12	0	12
"260618"	"FLIEGL Agrartechnik GmbH"	"12.999.01.162"	18	0	18
"260618"	"FLIEGL Agrartechnik GmbH"	"12.999.01.163"	16	0	16
"260618"	"FLIEGL Agrartechnik GmbH"	"12.999.01.188"	21	0	21
"260702"	"JOSEF GEIDOBLER & SOHN GMBH"	"12.999.01.001"	3	2	1
"260704"	"Goldhofer Aktiengesellschaft"	"12.999.01.001"	10	10	0
"260704"	"Goldhofer Aktiengesellschaft"	"12.999.01.003"	27	26	1
"260704"	"Goldhofer Aktiengesellschaft"	"12.999.01.008"	3	0	3
"260704"	"Goldhofer Aktiengesellschaft"	"12.999.01.162"	-29	6	-35
"260704"	"Goldhofer Aktiengesellschaft"	"12.999.01.163"	-4	2	-6
"260704"	"Goldhofer Aktiengesellschaft"	"12.999.01.188"	0	0	0
"260714"	"GLOGGER FAHRZEUGBAU GMBH"	"12.999.01.001"	0	0	0
"260714"	"GLOGGER FAHRZEUGBAU GMBH"	"12.999.01.003"	0	0	0
"260803"	"HUTTNER"	"12.999.01.001"	0	0	0
"260803"	"HUTTNER"	"12.999.01.003"	1	1	0
"260811"	"HUMBAUR GMBH"	"12.999.01.001"	9	9	0
"260811"	"HUMBAUR GMBH"	"12.999.01.003"	15	15	0
"260811"	"HUMBAUR GMBH"	"12.999.01.008"	4	0	4
"260811"	"HUMBAUR GMBH"	"12.999.01.162"	8	0	8
"260811"	"HUMBAUR GMBH"	"12.999.01.163"	2	0	2
"260813"	"HOFMANN"	"12.999.01.001"	1	0	1
"260813"	"HOFMANN"	"12.999.01.003"	1	0	1
"260813"	"HOFMANN"	"12.999.01.188"	1	0	1
"261115"	"KAFFL Fahrzeugbau GmbH"	"12.999.01.001"	0	0	0
"261132"	"KUVVETLI FAHRZEUGBAU e.K."	"12.999.01.001"	0	0	0
"261132"	"KUVVETLI FAHRZEUGBAU e.K."	"12.999.01.003"	0	0	0
"261203"	"LINDNER & FISCHER"	"12.999.01.001"	6	1	5
"261203"	"LINDNER & FISCHER"	"12.999.01.003"	1	1	0
"261203"	"LINDNER & FISCHER"	"12.999.01.008"	0	0	0
"261203"	"LINDNER & FISCHER"	"12.999.01.188"	6	0	6
"261305"	"ISM INDUSTRIESERVICE"	"12.999.01.001"	0	0	0
"261305"	"ISM INDUSTRIESERVICE"	"12.999.01.003"	0	0	0
"261305"	"ISM INDUSTRIESERVICE"	"12.999.01.188"	0	0	0
"261312"	"MEUSBURGER"	"12.999.01.001"	430	5	425
"261312"	"MEUSBURGER"	"12.999.01.003"	416	11	405
"261312"	"MEUSBURGER"	"12.999.01.008"	31	1	30
"261312"	"MEUSBURGER"	"12.999.01.162"	100	12	88
"261312"	"MEUSBURGER"	"12.999.01.163"	49	4	45
"261312"	"MEUSBURGER"	"12.999.01.188"	43	1	42
"261606"	"Paul Nutzfahrzeuge GmbH"	"12.999.01.001"	2	0	2
"261606"	"Paul Nutzfahrzeuge GmbH"	"12.999.01.003"	6	0	6
"261608"	"POPP FAHRZEUGBAU GMBH"	"12.999.01.001"	0	0	0
"261608"	"POPP FAHRZEUGBAU GMBH"	"12.999.01.003"	0	0	0
"261802"	"MARTIN REISCH GMBH"	"12.999.01.001"	3	1	2
"261802"	"MARTIN REISCH GMBH"	"12.999.01.003"	13	1	12
"261802"	"MARTIN REISCH GMBH"	"12.999.01.162"	6	0	6
"261802"	"MARTIN REISCH GMBH"	"12.999.01.163"	2	0	2
"261802"	"MARTIN REISCH GMBH"	"12.999.01.188"	16	1	15
"261809"	"MARTIN REISCH GMBH"	"12.999.01.001"	11	1	10
"261809"	"MARTIN REISCH GMBH"	"12.999.01.003"	6	0	6
"261809"	"MARTIN REISCH GMBH"	"12.999.01.162"	14	0	14
"261809"	"MARTIN REISCH GMBH"	"12.999.01.163"	3	0	3
"261809"	"MARTIN REISCH GMBH"	"12.999.01.188"	18	11	7
"261818"	"NUTZFAHRZEUGE ROHR GMBH"	"12.999.01.001"	24	6	18
"261818"	"NUTZFAHRZEUGE ROHR GMBH"	"12.999.01.003"	4	0	4
"261818"	"NUTZFAHRZEUGE ROHR GMBH"	"12.999.01.188"	24	5	19
"261905"	"ZF SACHS AG"	"12.999.01.001"	-36	0	-36
"261905"	"ZF SACHS AG"	"12.999.01.003"	0	5	-5
"262036"	"SCHMID FAHRZEUGBAU GMBH"	"12.999.01.001"	1	0	1
"262036"	"SCHMID FAHRZEUGBAU GMBH"	"12.999.01.003"	2	0	2
"262103"	"AUTOTEILE STREB"	"12.999.01.001"	12	6	6
"262103"	"AUTOTEILE STREB"	"12.999.01.003"	1	0	1
"262217"	"TROST AUTO SERVICE TECHNIK SE"	"12.999.01.001"	1	0	1
"262217"	"TROST AUTO SERVICE TECHNIK SE"	"12.999.01.003"	2	0	2
"262404"	"REINHARD VACHAL"	"12.999.01.001"	2	0	2
"262404"	"REINHARD VACHAL"	"12.999.01.003"	3	0	3
"262506"	"KURT WILLIG GMBH & CO. KG"	"12.999.01.001"	1	0	1
"262506"	"KURT WILLIG GMBH & CO. KG"	"12.999.01.003"	3	0	3
"262509"	"WINKLER FAHRZEUGTEILE GMBH"	"12.999.01.001"	0	0	0
"262510"	"WAGNER-FAHRZEUGBAU GMBH"	"12.999.01.001"	0	0	0
"262703"	"ZUNHAMMER GMBH"	"12.999.01.001"	9	0	9
"262703"	"ZUNHAMMER GMBH"	"12.999.01.003"	4	0	4
"262705"	"Zanner Fahrzeugbau GmbH"	"12.999.01.001"	1	1	0
"262706"	"ZEBU FAHRZEUGBAU GmbH & Co. KG"	"12.999.01.001"	2	0	2
"262706"	"ZEBU FAHRZEUGBAU GmbH & Co. KG"	"12.999.01.003"	2	0	2
"263015"	"BAYWA AG"	"12.999.01.001"	1	1	0
"270104"	"ANNABURGER NUTZFAHRZEUG GMBH"	"12.999.01.001"	5	2	3
"270104"	"ANNABURGER NUTZFAHRZEUG GMBH"	"12.999.01.003"	8	2	6
"270119"	"ACKERMANN FAHRZEUGBAU"	"12.999.01.001"	27	3	24
"270119"	"ACKERMANN FAHRZEUGBAU"	"12.999.01.003"	10	2	8
"270119"	"ACKERMANN FAHRZEUGBAU"	"12.999.01.188"	21	2	19
"270204"	"BEFA  BELZIGER-"	"12.999.01.001"	1	1	0
"270204"	"BEFA  BELZIGER-"	"12.999.01.162"	2	2	0
"270204"	"BEFA  BELZIGER-"	"12.999.01.163"	1	1	0
"270404"	"Kurt Dinkel"	"12.999.01.001"	18	1	17
"270404"	"Kurt Dinkel"	"12.999.01.188"	1	1	0
"270513"	"Federn-Oßwald Fahrzeugteile &"	"12.999.01.003"	0	0	0
"270620"	"Feldbinder"	"12.999.01.001"	27	12	15
"270620"	"Feldbinder"	"12.999.01.003"	7	2	5
"270620"	"Feldbinder"	"12.999.01.008"	-1	1	-2
"270620"	"Feldbinder"	"12.999.01.162"	1	0	1
"270620"	"Feldbinder"	"12.999.01.163"	0	0	0
"270620"	"Feldbinder"	"12.999.01.188"	23	17	6
"270622"	"FRANK FAHRZEUGBAU GMBH"	"12.999.01.001"	0	0	0
"270624"	"FAG"	"12.999.01.001"	0	0	0
"270624"	"FAG"	"12.999.01.003"	-1	0	-1
"270624"	"FAG"	"12.999.01.188"	1	0	1
"270804"	"Hüffermann"	"12.999.01.001"	26	7	19
"270804"	"Hüffermann"	"12.999.01.003"	8	8	0
"270804"	"Hüffermann"	"12.999.01.008"	-1	0	-1
"270804"	"Hüffermann"	"12.999.01.162"	79	14	65
"270804"	"Hüffermann"	"12.999.01.163"	11	5	6
"270804"	"Hüffermann"	"12.999.01.188"	16	8	8
"270805"	"HERZ NUTZFAHRZEUGTEILE GMBH"	"12.999.01.001"	1	1	0
"270805"	"HERZ NUTZFAHRZEUGTEILE GMBH"	"12.999.01.003"	0	0	0
"270810"	"HKM FAHRZEUGBAU GMBH"	"12.999.01.001"	12	17	-5
"270810"	"HKM FAHRZEUGBAU GMBH"	"12.999.01.003"	10	10	0
"270810"	"HKM FAHRZEUGBAU GMBH"	"12.999.01.162"	2	2	0
"270810"	"HKM FAHRZEUGBAU GMBH"	"12.999.01.163"	1	1	0
"270810"	"HKM FAHRZEUGBAU GMBH"	"12.999.01.188"	1	1	0
"270815"	"HELLMERS GMBH"	"12.999.01.001"	0	0	0
"270815"	"HELLMERS GMBH"	"12.999.01.188"	0	0	0
"271102"	"FRANK & SOHN"	"12.999.01.001"	4	4	0
"271114"	"Kirow Ardelt GmbH"	"12.999.01.003"	4	0	4
"271118"	"PLATAL MOBILSYSTEME GMBH"	"12.999.01.001"	0	0	0
"271118"	"PLATAL MOBILSYSTEME GMBH"	"12.999.01.003"	0	0	0
"271307"	"FMS Fahrzeugbau GmbH"	"12.999.01.001"	6	5	1
"271307"	"FMS Fahrzeugbau GmbH"	"12.999.01.003"	-1	0	-1
"271307"	"FMS Fahrzeugbau GmbH"	"12.999.01.162"	8	8	0
"271307"	"FMS Fahrzeugbau GmbH"	"12.999.01.163"	2	2	0
"271307"	"FMS Fahrzeugbau GmbH"	"12.999.01.188"	1	1	0
"271311"	"MAFA"	"12.999.01.001"	22	0	22
"271311"	"MAFA"	"12.999.01.008"	0	0	0
"271311"	"MAFA"	"12.999.01.162"	-4	0	-4
"271311"	"MAFA"	"12.999.01.163"	0	0	0
"271311"	"MAFA"	"12.999.01.188"	26	0	26
"271318"	"MKF"	"12.999.01.003"	0	0	0
"271505"	"ORTEN GmbH & Co. KG"	"12.999.01.001"	1	0	1
"271505"	"ORTEN GmbH & Co. KG"	"12.999.01.003"	-1	0	-1
"271910"	"SAXAS"	"12.999.01.001"	0	0	0
"271910"	"SAXAS"	"12.999.01.008"	1	0	1
"272017"	"Schmitz Cargobull"	"12.999.01.001"	10	3	7
"272017"	"Schmitz Cargobull"	"12.999.01.003"	1	1	0
"272017"	"Schmitz Cargobull"	"12.999.01.008"	2	1	1
"272017"	"Schmitz Cargobull"	"12.999.01.188"	6	5	1
"272502"	"Schlosser Europart"	"12.999.01.001"	2	0	2
"272502"	"Schlosser Europart"	"12.999.01.003"	2	0	2
"272502"	"Schlosser Europart"	"12.999.01.008"	1	0	1
"272505"	"WILLIG FAHRZEUGBAU GMBH"	"12.999.01.001"	0	0	0
"272505"	"WILLIG FAHRZEUGBAU GMBH"	"12.999.01.003"	0	0	0
"272505"	"WILLIG FAHRZEUGBAU GMBH"	"12.999.01.008"	0	0	0
"272505"	"WILLIG FAHRZEUGBAU GMBH"	"12.999.01.188"	5	0	5
"272506"	"WESSEL-FAHRZEUGTEILE GMBH"	"12.999.01.001"	4	4	0
"272506"	"WESSEL-FAHRZEUGTEILE GMBH"	"12.999.01.003"	1	1	0
"272516"	"EUROPART  Trading GMBH"	"12.999.01.008"	0	0	0
"310052"	"BOTHE-SCHNITZIUS GMBH & CO."	"12.999.01.003"	1	1	0
"320006"	"OFFERGELD GMBH & CO."	"12.999.01.001"	1	0	1
"320037"	"Frye Transport-Logistik GMBH"	"12.999.01.003"	-114	410	-524
"320080"	"GEORG KRAEMER FAHRZEUGBAU"	"12.999.01.001"	0	0	0
"320080"	"GEORG KRAEMER FAHRZEUGBAU"	"12.999.01.003"	0	0	0
"320102"	"NCG NUTZFAHRZEUG-CENTER GMBH"	"12.999.01.001"	1	0	1
"320132"	"KAMAX-WERKE"	"12.999.01.003"	6	28	-22
"320132"	"KAMAX-WERKE"	"12.999.01.008"	574	270	304
"320147"	"JOHANNES REINERS"	"12.999.01.001"	1	0	1
"320150"	"Nagel-Group"	"12.999.01.001"	1	0	1
"320150"	"Nagel-Group"	"12.999.01.003"	2	0	2
"350003"	"FRITZ BRAUN FAHRZEUGBAU"	"12.999.01.001"	0	0	0
"350003"	"FRITZ BRAUN FAHRZEUGBAU"	"12.999.01.003"	0	0	0
"360083"	"FEDLMEIER GMBH"	"12.999.01.001"	1	1	0
"360083"	"FEDLMEIER GMBH"	"12.999.01.003"	1	1	0
"360132"	"P. SCHWANDNER"	"12.999.01.001"	1	0	1
"370002"	"SCANRO GMBH"	"12.999.01.001"	3	3	0
"370046"	"Elflein Spedition & Transport GmbH"	"12.999.01.001"	1	0	1
"370046"	"Elflein Spedition & Transport GmbH"	"12.999.01.003"	1	0	1
"370111"	"Richter GmbH & Co.KG"	"12.999.01.003"	0	0	0
"370175"	"Manfred Manig"	"12.999.01.001"	1	0	1
"390502"	"WINCANTON TRANS EUROPEAN (D) GmbH"	"12.999.01.003"	-4	0	-4
"390503"	"WIELAND-WERKE AG"	"12.999.01.001"	8	0	8
"390503"	"WIELAND-WERKE AG"	"12.999.01.003"	-59	0	-59
"390510"	"TMD FRICTION GMBH"	"12.999.01.001"	330	180	150
"390510"	"TMD FRICTION GMBH"	"12.999.01.003"	207	54	153
"390510"	"TMD FRICTION GMBH"	"12.999.01.008"	812	433	379
"390511"	"SONA BLW"	"12.999.01.001"	-3	0	-3
"390511"	"SONA BLW"	"12.999.01.003"	-1	0	-1
"390513"	"THIEL & HOCHE GMBH & CO. KG"	"12.999.01.001"	49	60	-11
"390513"	"THIEL & HOCHE GMBH & CO. KG"	"12.999.01.003"	17	0	17
"390513"	"THIEL & HOCHE GMBH & CO. KG"	"12.999.01.008"	53	0	53
"390514"	"THH DREHTEILE GMBH"	"12.999.01.001"	3	0	3
"390514"	"THH DREHTEILE GMBH"	"12.999.01.003"	-4	0	-4
"390516"	"ERICH SYDOW GMBH & CO. KG"	"12.999.01.003"	-1	0	-1
"390519"	"SKF GmbH"	"12.999.01.003"	204	15	189
"390525"	"SCHIEFFER GMBH & CO. KG"	"12.999.01.001"	63	0	63
"390525"	"SCHIEFFER GMBH & CO. KG"	"12.999.01.003"	-18	2	-20
"390525"	"SCHIEFFER GMBH & CO. KG"	"12.999.01.008"	82	0	82
"390526"	"SCHENKER"	"12.999.01.001"	-34	0	-34
"390528"	"ADOLF PUEHL GMBH & CO. KG"	"12.999.01.003"	-99	0	-99
"390530"	"PEINER UMFORMTECHNIK GMBH"	"12.999.01.003"	-161	0	-161
"390530"	"PEINER UMFORMTECHNIK GMBH"	"12.999.01.008"	1	0	1
"390531"	"ALEXANDER PAAL GMBH"	"12.999.01.003"	-116	0	-116
"390531"	"ALEXANDER PAAL GMBH"	"12.999.01.008"	102	0	102
"390533"	"NEUHAUS"	"12.999.01.001"	87	0	87
"390533"	"NEUHAUS"	"12.999.01.003"	-112	0	-112
"390533"	"NEUHAUS"	"12.999.01.008"	150	0	150
"390534"	"TNT Innight GmbH & Co.KG"	"12.999.01.001"	73	19	54
"390534"	"TNT Innight GmbH & Co.KG"	"12.999.01.003"	4	0	4
"390537"	"MOHR + FRIEDRICH GMBH"	"12.999.01.001"	1	0	1
"390537"	"MOHR + FRIEDRICH GMBH"	"12.999.01.003"	-192	50	-242
"390537"	"MOHR + FRIEDRICH GMBH"	"12.999.01.008"	151	0	151
"390538"	"GUSTAV MEYER GMBH & CO."	"12.999.01.003"	5	0	5
"390538"	"GUSTAV MEYER GMBH & CO."	"12.999.01.008"	32	0	32
"390539"	"MAYER-JUMBO"	"12.999.01.001"	2	0	2
"390542"	"LST - GMBH"	"12.999.01.001"	-8	0	-8
"390542"	"LST - GMBH"	"12.999.01.003"	1	0	1
"390543"	"LIPPISCHE EISENINDUSTRIE GMBH"	"12.999.01.003"	-530	10	-540
"390543"	"LIPPISCHE EISENINDUSTRIE GMBH"	"12.999.01.008"	190	100	90
"390546"	"GESENK- UND FREIFORMSCHMIEDE"	"12.999.01.001"	-14	0	-14
"390555"	"KAUSEMANN GMBH"	"12.999.01.001"	6	0	6
"390556"	"JOHNSON DREHTECHNIK GMBH"	"12.999.01.003"	21	0	21
"390556"	"JOHNSON DREHTECHNIK GMBH"	"12.999.01.008"	26	0	26
"390557"	"WALTER HUNDHAUSEN GMBH"	"12.999.01.001"	-42	0	-42
"390557"	"WALTER HUNDHAUSEN GMBH"	"12.999.01.003"	-1	0	-1
"390560"	"HEINRICHS GMBH"	"12.999.01.001"	48	0	48
"390560"	"HEINRICHS GMBH"	"12.999.01.003"	3	0	3
"390560"	"HEINRICHS GMBH"	"12.999.01.008"	16	0	16
"390563"	"GUEDE GMBH"	"12.999.01.003"	-7	0	-7
"390563"	"GUEDE GMBH"	"12.999.01.008"	-26	2	-28
"390564"	"Heinrich Glane GmbH"	"12.999.01.001"	-35	6	-41
"390564"	"Heinrich Glane GmbH"	"12.999.01.003"	-714	129	-843
"390567"	"FUCHS SCHRAUBENWERK"	"12.999.01.003"	-38	0	-38
"390567"	"FUCHS SCHRAUBENWERK"	"12.999.01.008"	93	0	93
"390568"	"FORMTEIL- UND SCHRAUBENWERK"	"12.999.01.003"	139	0	139
"390569"	"AUGUST FRIEDBERG GMBH"	"12.999.01.003"	-232	0	-232
"390569"	"AUGUST FRIEDBERG GMBH"	"12.999.01.008"	407	0	407
"390570"	"FREUDENBERG SIMRIT KG"	"12.999.01.001"	-10	0	-10
"390570"	"FREUDENBERG SIMRIT KG"	"12.999.01.003"	-141	0	-141
"390571"	"ANDREAS FRANKE"	"12.999.01.003"	1	0	1
"390572"	"Wälzlager GmbH"	"12.999.01.001"	1	0	1
"390572"	"Wälzlager GmbH"	"12.999.01.003"	274	295	-21
"390572"	"Wälzlager GmbH"	"12.999.01.008"	1	650	-649
"390574"	"SAF-Holland GmbH"	"12.999.01.001"	21	0	21
"390574"	"SAF-Holland GmbH"	"12.999.01.003"	-11	0	-11
"390574"	"SAF-Holland GmbH"	"12.999.01.008"	90	0	90
"390575"	"FELDMANN-MAB"	"12.999.01.003"	-17	0	-17
"390575"	"FELDMANN-MAB"	"12.999.01.008"	13	0	13
"390576"	"CFS FALKENROTH UMFORMTECHNIK"	"12.999.01.001"	14	0	14
"390577"	"ESAB GMBH"	"12.999.01.003"	-203	0	-203
"390580"	"RUDOLF ECKEL"	"12.999.01.001"	9	0	9
"390580"	"RUDOLF ECKEL"	"12.999.01.003"	9	0	9
"390581"	"JOSEPH DRESSELHAUS"	"12.999.01.003"	-226	20	-246
"390581"	"JOSEPH DRESSELHAUS"	"12.999.01.008"	249	200	49
"390583"	"Obermann Logistik GmbH"	"12.999.01.003"	0	0	0
"390587"	"Sped. Dachser GmbH & Co. KG"	"12.999.01.003"	-1	0	-1
"402773"	"NICOLAS"	"12.999.01.162"	0	0	0
"402773"	"NICOLAS"	"12.999.01.163"	0	0	0
"404089"	"Rejna"	"12.999.01.001"	1	0	1
"404404"	"TPV d.d."	"12.999.01.001"	88	0	88
"406692"	"SLR-GUSSWERK II"	"12.999.01.001"	1	0	1
"408204"	"LECITRAILER S.A."	"12.999.01.001"	0	0	0
"408237"	"FUNDICIONES DE VERA S.A."	"12.999.01.001"	1	4	-3
"408237"	"FUNDICIONES DE VERA S.A."	"12.999.01.003"	275	0	275
"409002"	"F. X. MEILLER SLANY S.R.O."	"12.999.01.001"	13	10	3
"409002"	"F. X. MEILLER SLANY S.R.O."	"12.999.01.003"	-3	8	-11
"409002"	"F. X. MEILLER SLANY S.R.O."	"12.999.01.008"	2	0	2
"409002"	"F. X. MEILLER SLANY S.R.O."	"12.999.01.162"	0	0	0
"409002"	"F. X. MEILLER SLANY S.R.O."	"12.999.01.163"	0	0	0
"409002"	"F. X. MEILLER SLANY S.R.O."	"12.999.01.188"	37	23	14
"409004"	"BRANO A.S."	"12.999.01.001"	47	60	-13
"409004"	"BRANO A.S."	"12.999.01.003"	4	0	4
"416670"	"FAHRZEUGBEDARF"	"12.999.01.001"	211	61	150
"416670"	"FAHRZEUGBEDARF"	"12.999.01.003"	435	202	233
"416670"	"FAHRZEUGBEDARF"	"12.999.01.008"	-4	4	-8
"416670"	"FAHRZEUGBEDARF"	"12.999.01.162"	93	4	89
"416670"	"FAHRZEUGBEDARF"	"12.999.01.163"	17	2	15
"416670"	"FAHRZEUGBEDARF"	"12.999.01.188"	1	1	0
"416674"	"Hendrickson Austria GmbH"	"12.999.01.001"	169	14	155
"416674"	"Hendrickson Austria GmbH"	"12.999.01.003"	2	300	-298
"428413"	"MOM Faktor"	"12.999.01.003"	0	13	-13
"428413"	"MOM Faktor"	"12.999.01.008"	0	47	-47
"470055"	"Sievering Nutzfahrzeuge GmbH"	"12.999.01.003"	2	2	0
"490102"	"KUZNIA GLINIK SP.Z.O.O."	"12.999.01.001"	-15	0	-15
"490106"	"FORGING PRODUCTS S.A."	"12.999.01.001"	-60	0	-60
"490106"	"FORGING PRODUCTS S.A."	"12.999.01.003"	-62	0	-62
"490106"	"FORGING PRODUCTS S.A."	"12.999.01.008"	23	0	23
"490106"	"FORGING PRODUCTS S.A."	"12.999.01.011"	-26	0	-26
"490108"	"KAMAX S.R.O. TURNOV"	"12.999.01.003"	-34	0	-34
"490112"	"UNIOR DD"	"12.999.01.003"	78	0	78
"490112"	"UNIOR DD"	"12.999.01.008"	57	0	57
"500005"	"DUMMY-Sonderbestandsführer"	"12.999.01.001"	447	2	445
"500005"	"DUMMY-Sonderbestandsführer"	"12.999.01.003"	1	0	1
"500005"	"DUMMY-Sonderbestandsführer"	"12.999.01.008"	51	1	50
"500005"	"DUMMY-Sonderbestandsführer"	"12.999.01.011"	-2	0	-2
"500005"	"DUMMY-Sonderbestandsführer"	"12.999.01.162"	22	0	22
"500005"	"DUMMY-Sonderbestandsführer"	"12.999.01.163"	7	0	7
"500005"	"DUMMY-Sonderbestandsführer"	"12.999.01.188"	114	0	114
"500035"	"EUROPART Materials GmbH"	"12.999.01.001"	57	26	31
"500035"	"EUROPART Materials GmbH"	"12.999.01.003"	34	19	15
"500035"	"EUROPART Materials GmbH"	"12.999.01.008"	1	0	1
"500118"	"Cargobull Parts & Services GmbH"	"12.999.01.001"	40	23	17
"500118"	"Cargobull Parts & Services GmbH"	"12.999.01.003"	5	1	4
"500167"	"MN Kaltformteile"	"12.999.01.003"	-11	0	-11
"500182"	"Frohnauer GmbH"	"12.999.01.001"	1	0	1
"500219"	"Georg Fischer GmbH"	"12.999.01.001"	-34	127	-161
"500219"	"Georg Fischer GmbH"	"12.999.01.003"	36	0	36
"500219"	"Georg Fischer GmbH"	"12.999.01.008"	79	0	79
"500227"	"TROST AUTO SERVICE TECHNIK SE"	"12.999.01.003"	0	0	0
"500245"	"NTV Nutzfahrzeuge"	"12.999.01.001"	2	0	2
"500291"	"SVG EUROPART Südbaden GmbH"	"12.999.01.003"	1	1	0
"500304"	"EUROPART Trading GmbH"	"12.999.01.001"	0	0	0
"500310"	"Spermann Fahrzeugbau GmbH"	"12.999.01.001"	2	0	2
"500310"	"Spermann Fahrzeugbau GmbH"	"12.999.01.003"	2	0	2
"500318"	"Franz Fischer Spedition GmbH"	"12.999.01.003"	0	0	0
"500331"	"SW Umformtechnik"	"12.999.01.001"	34	32	2
"500331"	"SW Umformtechnik"	"12.999.01.003"	247	5	242
"500398"	"TROST AUTO SERVICE TECHNIK SE"	"12.999.01.003"	0	0	0
"500466"	"Hendricks Reparatur & Service"	"12.999.01.003"	1	1	0
"500570"	"RI-FA"	"12.999.01.001"	0	0	0
"500570"	"RI-FA"	"12.999.01.003"	0	0	0
"500621"	"PROFI PARTS"	"12.999.01.001"	2	0	2
"500640"	"Torwesten Spedition GmbH & Co. KG"	"12.999.01.003"	1	1	0
"500646"	"Schneider Fahrzeugteile"	"12.999.01.001"	1	1	0
"500706"	"HGE Fahrzeugbau GmbH & Co. KG"	"12.999.01.001"	1	0	1
"500706"	"HGE Fahrzeugbau GmbH & Co. KG"	"12.999.01.188"	2	0	2
"500757"	"TROST AUTO SERVICE TECHNIK SE"	"12.999.01.001"	1	0	1
"500800"	"Paul Scholz KG"	"12.999.01.003"	0	0	0
"500820"	"Hofmeister & Meincke GmbH & Co. KG"	"12.999.01.001"	1	0	1
"501044"	"Friedrich Kraft GmbH"	"12.999.01.001"	1	1	0
"501044"	"Friedrich Kraft GmbH"	"12.999.01.003"	0	0	0
"501048"	"Friedrich Kraft GmbH"	"12.999.01.003"	0	0	0
"501100"	"Stürenberg Fahrzeugbau GmbH"	"12.999.01.001"	0	0	0
"501100"	"Stürenberg Fahrzeugbau GmbH"	"12.999.01.003"	0	0	0
"501146"	"Schwarzmüller"	"12.999.01.188"	151	59	92
"501210"	"WüTSCHNER"	"12.999.01.001"	0	0	0
"501210"	"WüTSCHNER"	"12.999.01.003"	0	0	0
"501221"	"Polyma Energiesysteme GmbH"	"12.999.01.001"	2	0	2
"501233"	"OPTIMAS OE Solutions GmbH"	"12.999.01.003"	-83	0	-83
"501233"	"OPTIMAS OE Solutions GmbH"	"12.999.01.008"	5	0	5
"501243"	"Altha Industrieprodukte"	"12.999.01.003"	19	4	15
"501243"	"Altha Industrieprodukte"	"12.999.01.008"	44	40	4
"501305"	"Kuznia Jawor SA"	"12.999.01.001"	105	60	45
"501398"	"BIRNER GMBH"	"12.999.01.001"	0	0	0
"501401"	"Bäumle Spedition GmbH"	"12.999.01.001"	1	0	1
"501401"	"Bäumle Spedition GmbH"	"12.999.01.003"	2	0	2
"501473"	"Herbert Dammann GmbH"	"12.999.01.001"	0	0	0
"501508"	"A-W.Heil & Sohn GmbH & Co."	"12.999.01.001"	50	16	34
"501508"	"A-W.Heil & Sohn GmbH & Co."	"12.999.01.003"	7	3	4
"501508"	"A-W.Heil & Sohn GmbH & Co."	"12.999.01.008"	0	0	0
"501592"	"Paul Link GmbH & Co. KG"	"12.999.01.003"	0	0	0
"501611"	"WM SE"	"12.999.01.003"	0	0	0
"501620"	"Fietz Thermoplast"	"12.999.01.003"	-21	0	-21
"501681"	"TROST AUTO SERVICE TECHNIK SE"	"12.999.01.001"	1	0	1
"501871"	"Schmitt KFZ GmbH"	"12.999.01.003"	2	2	0
"501949"	"Heinrich Hamm Speditionsges."	"12.999.01.003"	1	1	0
"502119"	"Claas Service and Parts GmbH"	"12.999.01.003"	0	0	0
"502119"	"Claas Service and Parts GmbH"	"12.999.01.008"	26	0	26
"502219"	"Maschinenfabrik Bernard Krone GmbH"	"12.999.01.001"	3	0	3
"502219"	"Maschinenfabrik Bernard Krone GmbH"	"12.999.01.003"	1	0	1
"502560"	"Haerterei Hauck"	"12.999.01.001"	-7	0	-7
"502560"	"Haerterei Hauck"	"12.999.01.003"	-24	0	-24
"502560"	"Haerterei Hauck"	"12.999.01.008"	36	0	36
"502680"	"Finkl-Fahrzeugbau GmbH"	"12.999.01.001"	4	1	3
"502680"	"Finkl-Fahrzeugbau GmbH"	"12.999.01.003"	2	1	1
"502680"	"Finkl-Fahrzeugbau GmbH"	"12.999.01.162"	4	0	4
"502680"	"Finkl-Fahrzeugbau GmbH"	"12.999.01.163"	1	0	1
"502809"	"Franz Mersch GmbH & Co. KG"	"12.999.01.001"	1	0	1
"503038"	"Weißgerber/Seidner GmbH & Co"	"12.999.01.001"	39	6	33
"503038"	"Weißgerber/Seidner GmbH & Co"	"12.999.01.003"	156	9	147
"503131"	"Contitech Luftfedersysteme GmbH"	"12.999.01.001"	-2	0	-2
"503173"	"Bohnet GmbH"	"12.999.01.001"	5	0	5
"503208"	"Rainer Volk"	"12.999.01.001"	2	0	2
"503240"	"Wessels Vrees"	"12.999.01.001"	10	0	10
"503269"	"Sinco Tec"	"12.999.01.001"	4	0	4
"503313"	"Kaiser Fahrzeugbau GmbH"	"12.999.01.001"	0	0	0
"503313"	"Kaiser Fahrzeugbau GmbH"	"12.999.01.003"	0	0	0
"503313"	"Kaiser Fahrzeugbau GmbH"	"12.999.01.188"	0	0	0
"503356"	"Arnold Umformtechnik"	"12.999.01.003"	8	0	8
"503371"	"Heinrich Kruse"	"12.999.01.001"	0	0	0
"503490"	"B. Stade, Inh. M. Stade"	"12.999.01.003"	1	0	1
"503494"	"VCT Vogel GmbH"	"12.999.01.001"	2	0	2
"503494"	"VCT Vogel GmbH"	"12.999.01.003"	1	0	1
"503494"	"VCT Vogel GmbH"	"12.999.01.188"	1	0	1
"503550"	"ForFarmers GmbH"	"12.999.01.003"	1	1	0
"503634"	"Wessels + Müller AG"	"12.999.01.001"	1	0	1
"503853"	"Waldemar Fromm"	"12.999.01.001"	1	1	0
"503996"	"System Trailers GmbH"	"12.999.01.001"	71	10	61
"503996"	"System Trailers GmbH"	"12.999.01.003"	1	3	-2
"503996"	"System Trailers GmbH"	"12.999.01.008"	6	1	5
"503996"	"System Trailers GmbH"	"12.999.01.162"	14	0	14
"503996"	"System Trailers GmbH"	"12.999.01.163"	3	0	3
"503996"	"System Trailers GmbH"	"12.999.01.188"	75	27	48
"504155"	"Blumberg GmbH & Co. KG"	"12.999.01.003"	0	0	0
"504307"	"Zemmler"	"12.999.01.001"	3	3	0
"504307"	"Zemmler"	"12.999.01.003"	3	3	0
"504335"	"MAN Truck & Bus Deutschland GmbH"	"12.999.01.003"	0	0	0
"504337"	"RUFA Fahrzeugbau GmbH"	"12.999.01.001"	8	3	5
"504337"	"RUFA Fahrzeugbau GmbH"	"12.999.01.003"	6	3	3
"504337"	"RUFA Fahrzeugbau GmbH"	"12.999.01.188"	8	0	8
"504462"	"TMD Friction  GmbH Coswig"	"12.999.01.003"	3	0	3
"504483"	"Streicher Landmaschinen GmbH"	"12.999.01.001"	1	0	1
"504659"	"Hellmut Schmied Spedition"	"12.999.01.003"	0	0	0
"504689"	"HS-Schoch GmbH"	"12.999.01.001"	-91	0	-91
"504689"	"HS-Schoch GmbH"	"12.999.01.003"	-300	0	-300
"504728"	"Grimme Landmaschinentechnik"	"12.999.01.001"	11	0	11
"504728"	"Grimme Landmaschinentechnik"	"12.999.01.003"	2	1	1
"504728"	"Grimme Landmaschinentechnik"	"12.999.01.008"	6	2	4
"504824"	"Spedition Eberhard Gersch"	"12.999.01.003"	0	0	0
"504864"	"Lenicker GmbH"	"12.999.01.001"	2	0	2
"504880"	"Lisi Automotive-Knipping"	"12.999.01.003"	-14	0	-14
"504902"	"Peter Ortmann"	"12.999.01.001"	1	0	1
"505149"	"A. Sedlmaier GmbH"	"12.999.01.003"	0	0	0
"505279"	"Reiner Reichert"	"12.999.01.001"	1	0	1
"505279"	"Reiner Reichert"	"12.999.01.188"	2	0	2
"505303"	"Kurt Willig GmbH & Co. KG"	"12.999.01.001"	-3	3	-6
"505303"	"Kurt Willig GmbH & Co. KG"	"12.999.01.003"	3	0	3
"505303"	"Kurt Willig GmbH & Co. KG"	"12.999.01.162"	0	0	0
"505303"	"Kurt Willig GmbH & Co. KG"	"12.999.01.163"	0	0	0
"505303"	"Kurt Willig GmbH & Co. KG"	"12.999.01.188"	19	3	16
"505463"	"Nutzfahrzeug & Service"	"12.999.01.001"	0	0	0
"505463"	"Nutzfahrzeug & Service"	"12.999.01.188"	0	0	0
"505485"	"ELHA Maschinenbau"	"12.999.01.001"	-7	0	-7
"505485"	"ELHA Maschinenbau"	"12.999.01.003"	2	0	2
"505515"	"RMW Rotenburger"	"12.999.01.003"	34	0	34
"505519"	"Brueggen Komponenten GmbH"	"12.999.01.001"	674	69	605
"505519"	"Brueggen Komponenten GmbH"	"12.999.01.003"	23	4	19
"505519"	"Brueggen Komponenten GmbH"	"12.999.01.008"	59	9	50
"505519"	"Brueggen Komponenten GmbH"	"12.999.01.162"	16	0	16
"505519"	"Brueggen Komponenten GmbH"	"12.999.01.163"	3	0	3
"505519"	"Brueggen Komponenten GmbH"	"12.999.01.188"	208	180	28
"505548"	"Colombo Special Fasteners"	"12.999.01.003"	16	0	16
"505548"	"Colombo Special Fasteners"	"12.999.01.008"	59	0	59
"505567"	"HOYER"	"12.999.01.001"	0	0	0
"505595"	"Koch GmbH & Co. KG"	"12.999.01.001"	2	2	0
"505663"	"Schaeffler  KG"	"12.999.01.003"	-1	0	-1
"505664"	"Springfix"	"12.999.01.003"	19	0	19
"505666"	"Pöppelmann GmbH & Co."	"12.999.01.003"	-17	0	-17
"505668"	"Willi Hahn GmbH"	"12.999.01.003"	-9	0	-9
"505695"	"Knoll GmbH"	"12.999.01.001"	-2	0	-2
"505735"	"Südbeck"	"12.999.01.001"	0	0	0
"505737"	"Vollmer + Boch"	"12.999.01.001"	55	0	55
"505737"	"Vollmer + Boch"	"12.999.01.003"	46	0	46
"505738"	"Mildner Fahrzeugbau GmbH"	"12.999.01.001"	30	1	29
"505738"	"Mildner Fahrzeugbau GmbH"	"12.999.01.003"	2	2	0
"505738"	"Mildner Fahrzeugbau GmbH"	"12.999.01.008"	6	0	6
"505738"	"Mildner Fahrzeugbau GmbH"	"12.999.01.188"	2	0	2
"505825"	"Geroh GmbH & Co. KG"	"12.999.01.003"	0	0	0
"505856"	"CT Kran-Cervice GmbH"	"12.999.01.001"	2	0	2
"505910"	"Wilhelm Schauerte"	"12.999.01.001"	-20	0	-20
"505910"	"Wilhelm Schauerte"	"12.999.01.003"	3	0	3
"505910"	"Wilhelm Schauerte"	"12.999.01.008"	8	0	8
"506215"	"Walter Fink"	"12.999.01.001"	1	0	1
"506371"	"LS Kunststofftechnologie GmbH"	"12.999.01.003"	-26	0	-26
"506466"	"BayWa AG Obertraubling"	"12.999.01.001"	1	0	1
"506695"	"Rauch Landmaschinenfabrik Gmbh"	"12.999.01.008"	1	0	1
"506832"	"Johann Vitz GmbH & Co. KG"	"12.999.01.003"	-12	0	-12
"506991"	"Eurotank GmbH"	"12.999.01.001"	4	2	2
"506991"	"Eurotank GmbH"	"12.999.01.008"	0	0	0
"506991"	"Eurotank GmbH"	"12.999.01.188"	1	0	1
"507049"	"Tenneco Automotive"	"12.999.01.001"	-20	0	-20
"507063"	"Liebherr-Mischtechnik GmbH"	"12.999.01.003"	0	0	0
"507427"	"Heinrich Stratmann GmbH"	"12.999.01.003"	0	0	0
"507539"	"Benninghoven"	"12.999.01.003"	2	0	2
"507576"	"Tiemann Truck & Bus GmbH"	"12.999.01.001"	1	1	0
"507576"	"Tiemann Truck & Bus GmbH"	"12.999.01.003"	1	1	0
"507597"	"Kögel Trailer GmbH & Co. KG"	"12.999.01.001"	44	12	32
"507597"	"Kögel Trailer GmbH & Co. KG"	"12.999.01.003"	1	0	1
"507597"	"Kögel Trailer GmbH & Co. KG"	"12.999.01.008"	2	2	0
"507597"	"Kögel Trailer GmbH & Co. KG"	"12.999.01.162"	6	0	6
"507597"	"Kögel Trailer GmbH & Co. KG"	"12.999.01.163"	2	0	2
"507597"	"Kögel Trailer GmbH & Co. KG"	"12.999.01.188"	141	38	103
"507646"	"Mager GmbH"	"12.999.01.001"	-16	0	-16
"507646"	"Mager GmbH"	"12.999.01.003"	3	0	3
"507646"	"Mager GmbH"	"12.999.01.008"	19	0	19
"507679"	"Amazone Technologie Leeden"	"12.999.01.008"	1	0	1
"507683"	"MTE"	"12.999.01.001"	0	0	0
"507737"	"Möller Fahrzeugbau"	"12.999.01.001"	1	0	1
"507737"	"Möller Fahrzeugbau"	"12.999.01.008"	1	0	1
"507738"	"Eckstein GmbH & Co.KG"	"12.999.01.001"	8	0	8
"507738"	"Eckstein GmbH & Co.KG"	"12.999.01.003"	13	0	13
"507778"	"Breuer & Wasel GmbH"	"12.999.01.001"	1	0	1
"507852"	"Müller Fahrzeugbau GmbH"	"12.999.01.003"	0	0	0
"507864"	"Dietsch Speditionsges.mbH"	"12.999.01.003"	1	0	1
"508072"	"Fahrzeugbau Ladeburg"	"12.999.01.001"	1	1	0
"508122"	"Reinhard Darming"	"12.999.01.003"	3	2	1
"508162"	"Zuern Harvesting GmbH & Co. KG"	"12.999.01.001"	5	0	5
"508219"	"TROST AUTO SERVICE TECHNIK SE"	"12.999.01.001"	34	8	26
"508219"	"TROST AUTO SERVICE TECHNIK SE"	"12.999.01.003"	7	3	4
"508293"	"Pankoke & Roll GmbH & Co.KG"	"12.999.01.001"	1	1	0
"508471"	"Grotlüschen Fahrzeugbau oHG"	"12.999.01.003"	1	1	0
"508535"	"Blomenröhr Fahrzeugbau"	"12.999.01.001"	1	0	1
"508535"	"Blomenröhr Fahrzeugbau"	"12.999.01.003"	1	0	1
"508628"	"Beilharz Nutzfahrzeuge Duisburg Gmb"	"12.999.01.001"	13	0	13
"508628"	"Beilharz Nutzfahrzeuge Duisburg Gmb"	"12.999.01.003"	5	1	4
"508794"	"Agravis Technik Saltenbrock GmbH"	"12.999.01.001"	1	0	1
"508946"	"He - Wa Aufbau"	"12.999.01.001"	5	0	5
"508946"	"He - Wa Aufbau"	"12.999.01.003"	4	0	4
"508946"	"He - Wa Aufbau"	"12.999.01.008"	3	0	3
"508979"	"Lemmer GmbH & Co. KG"	"12.999.01.001"	-92	0	-92
"508979"	"Lemmer GmbH & Co. KG"	"12.999.01.003"	89	0	89
"508979"	"Lemmer GmbH & Co. KG"	"12.999.01.008"	40	0	40
"509379"	"Vibracoustic CV Air Springs"	"12.999.01.001"	-123	510	-633
"509379"	"Vibracoustic CV Air Springs"	"12.999.01.003"	19	1	18
"509379"	"Vibracoustic CV Air Springs"	"12.999.01.008"	28	6	22
"509460"	"Frauenthal Automotive"	"12.999.01.001"	75	0	75
"509460"	"Frauenthal Automotive"	"12.999.01.003"	82	0	82
"509460"	"Frauenthal Automotive"	"12.999.01.008"	183	0	183
"509494"	"TIP Trailer Services Germany GmbH"	"12.999.01.003"	0	0	0
"509890"	"HZ - Elbe Autoersatzt.. GmbH & CO."	"12.999.01.001"	1	0	1
"509953"	"PM Hermann Perk"	"12.999.01.001"	2	0	2
"509953"	"PM Hermann Perk"	"12.999.01.008"	1	0	1
"510352"	"Autohaus Anders GmbH"	"12.999.01.001"	0	0	0
"510569"	"FLEXIMOL"	"12.999.01.001"	112	0	112
"510569"	"FLEXIMOL"	"12.999.01.003"	-3	0	-3
"510782"	"Hanisch GmbH"	"12.999.01.003"	0	0	0
"510946"	"Sebastian Obermaier"	"12.999.01.001"	1	0	1
"510946"	"Sebastian Obermaier"	"12.999.01.003"	1	0	1
"511014"	"DFF Federn und Fahrzeugteile GmbH"	"12.999.01.003"	0	0	0
"511327"	"Rübsam & Co."	"12.999.01.001"	3	0	3
"511327"	"Rübsam & Co."	"12.999.01.008"	11	0	11
"511368"	"M Reithelshöfer GMBH"	"12.999.01.001"	1	0	1
"511577"	"Friedrich Kraft GmbH"	"12.999.01.001"	1	1	0
"511885"	"CIMC Silvergreen Germany GmbH"	"12.999.01.001"	1	0	1
"511885"	"CIMC Silvergreen Germany GmbH"	"12.999.01.188"	23	0	23
"511928"	"Kögel, s. r. o."	"12.999.01.001"	-16	0	-16
"511928"	"Kögel, s. r. o."	"12.999.01.003"	0	0	0
"512068"	"SIGA Fahrzeugtechnik"	"12.999.01.188"	1	0	1
"512338"	"H & W"	"12.999.01.001"	12	5	7
"512338"	"H & W"	"12.999.01.003"	8	6	2
"512338"	"H & W"	"12.999.01.008"	6	5	1
"512338"	"H & W"	"12.999.01.162"	8	2	6
"512338"	"H & W"	"12.999.01.163"	3	1	2
"512338"	"H & W"	"12.999.01.188"	5	0	5
"512540"	"Emil Giebel"	"12.999.01.001"	1	1	0
"512578"	"TBZ GmbH"	"12.999.01.001"	6	0	6
"512578"	"TBZ GmbH"	"12.999.01.003"	6	0	6
"512611"	"K+G tec GmbH"	"12.999.01.001"	6	0	6
"512611"	"K+G tec GmbH"	"12.999.01.188"	9	0	9
"512620"	"Fellechner Fahrzeugbau GmbH"	"12.999.01.001"	7	5	2
"512620"	"Fellechner Fahrzeugbau GmbH"	"12.999.01.003"	8	5	3
"512620"	"Fellechner Fahrzeugbau GmbH"	"12.999.01.008"	2	2	0
"512620"	"Fellechner Fahrzeugbau GmbH"	"12.999.01.162"	2	2	0
"512620"	"Fellechner Fahrzeugbau GmbH"	"12.999.01.163"	1	1	0
"512620"	"Fellechner Fahrzeugbau GmbH"	"12.999.01.188"	3	3	0
"512847"	"GEREP"	"12.999.01.001"	-10	0	-10
"512886"	"Exporient Middle East for"	"12.999.01.003"	1	1	0
"512941"	"E. Heidrich"	"12.999.01.001"	0	0	0
"513076"	"Spedition Calenberg"	"12.999.01.001"	0	0	0
"513211"	"Schuler Fahrzeugbau GmbH"	"12.999.01.001"	7	1	6
"513721"	"Kumm Technik GmbH"	"12.999.01.001"	1	0	1
"513721"	"Kumm Technik GmbH"	"12.999.01.003"	2	0	2
"513775"	"Kreitz"	"12.999.01.001"	1	0	1
"514085"	"NTV Nutzfahrzeugteile Oesterhaus KG"	"12.999.01.001"	1	0	1
"514300"	"Otto Fuchs KG"	"12.999.01.003"	6	0	6
"514300"	"Otto Fuchs KG"	"12.999.01.008"	87	0	87
"514346"	"Prodinger oHG"	"12.999.01.003"	0	0	0
"514535"	"CTJ Janssen GmbH"	"12.999.01.001"	1	0	1
"514681"	"Universal Transport Schmitz"	"12.999.01.001"	2	0	2
"514868"	"BMD Baumechanisierung"	"12.999.01.001"	1	0	1
"518187"	"Modschiedler Logistik GmbH"	"12.999.01.001"	0	0	0
"520059"	"BST - Transporte"	"12.999.01.001"	1	0	1
"520059"	"BST - Transporte"	"12.999.01.003"	2	0	2
"520549"	"Georg Wagner KG"	"12.999.01.001"	3	0	3
"520549"	"Georg Wagner KG"	"12.999.01.003"	4	0	4
"522550"	"Bauer Truckcenter Wernberg"	"12.999.01.003"	0	0	0
"522748"	"Grieshaber Logistik AG"	"12.999.01.001"	1	0	1
"523639"	"Hofmeister & Meincke GmbH & Co.KG"	"12.999.01.001"	1	0	1
"523733"	"TAXO-Obermaier  GmbH"	"12.999.01.003"	11	2	9
"523740"	"Fasieco GmbH"	"12.999.01.001"	2	0	2
"523768"	"Moehling GmbH"	"12.999.01.003"	-39	5	-44
"523768"	"Moehling GmbH"	"12.999.01.008"	88	50	38
"523926"	"Forma Maschinenbau"	"12.999.01.001"	12	0	12
"523926"	"Forma Maschinenbau"	"12.999.01.008"	12	0	12
"523991"	"BRÜGGEN"	"12.999.01.003"	2	2	0
"523992"	"Dennis Struß"	"12.999.01.001"	0	0	0
"524088"	"ZAL GmbH"	"12.999.01.001"	0	0	0
"524141"	"Karl Groll GmbH + Co. KG"	"12.999.01.001"	3	0	3
"524459"	"Schreibmüller"	"12.999.01.001"	1	0	1
"524459"	"Schreibmüller"	"12.999.01.003"	1	0	1
"524464"	"Schondelmaier GmbH"	"12.999.01.001"	20	0	20
"524464"	"Schondelmaier GmbH"	"12.999.01.003"	1	0	1
"524478"	"Vibracoustic Polska SP. ZO.O."	"12.999.01.001"	1	0	1
"524478"	"Vibracoustic Polska SP. ZO.O."	"12.999.01.003"	8	0	8
"524507"	"Landwirtschaftsbetrieb Rienitz"	"12.999.01.003"	0	0	0
"524507"	"Landwirtschaftsbetrieb Rienitz"	"12.999.01.008"	0	0	0
"524612"	"Schuler Spezialfahrzeuge GmbH"	"12.999.01.001"	0	0	0
"524775"	"Neumeister Hydraulik GmbH"	"12.999.01.001"	6	0	6
"524775"	"Neumeister Hydraulik GmbH"	"12.999.01.003"	1	0	1
"524775"	"Neumeister Hydraulik GmbH"	"12.999.01.008"	9	0	9
"524927"	"PV Automotive GmbH"	"12.999.01.003"	0	0	0
"525106"	"Trost Auto Service Technik"	"12.999.01.001"	5	0	5
"525106"	"Trost Auto Service Technik"	"12.999.01.003"	3	0	3
"525395"	"Toni Hotz Transporte"	"12.999.01.001"	3	0	3
"525422"	"Rasche"	"12.999.01.001"	-35	0	-35
"525611"	"Massfeller GmbH"	"12.999.01.001"	2	0	2
"525936"	"Wolfgang Wagenblast"	"12.999.01.001"	1	0	1
"525942"	"Agrargenossenschaft Werratal e.G."	"12.999.01.003"	0	0	0
"526093"	"Zachler Transport"	"12.999.01.003"	0	0	0
"526214"	"JW-TEC"	"12.999.01.001"	0	0	0
"526214"	"JW-TEC"	"12.999.01.188"	0	0	0
"526228"	"BC Trans GmbH & Co. KG"	"12.999.01.001"	1	0	1
"526372"	"Trost Auto Service Technik SE"	"12.999.01.001"	75	5	70
"526372"	"Trost Auto Service Technik SE"	"12.999.01.003"	60	3	57
"526405"	"Unipro"	"12.999.01.001"	0	0	0
"526481"	"ASEAG GmbH"	"12.999.01.001"	1	0	1
"526506"	"BHC Gummi-Metall GmbH"	"12.999.01.001"	-34	0	-34
"526506"	"BHC Gummi-Metall GmbH"	"12.999.01.003"	-5	0	-5
"526506"	"BHC Gummi-Metall GmbH"	"12.999.01.008"	-14	0	-14
"527504"	"AI Metalltechnik GmbH & Co. KG"	"12.999.01.001"	9	0	9
"527641"	"Winkler Fahrzeugteile GmbH"	"12.999.01.001"	0	0	0
"527678"	"SVG Autohof Stuttgart-Wangen"	"12.999.01.001"	1	0	1
"527702"	"Wütschner Fahrzeugteile GmbH"	"12.999.01.001"	2	2	0
"527712"	"LINDENAU Full Tank Services GMBH"	"12.999.01.001"	1	1	0
"527712"	"LINDENAU Full Tank Services GMBH"	"12.999.01.188"	1	1	0
"527818"	"WM SE"	"12.999.01.001"	0	0	0
"527818"	"WM SE"	"12.999.01.003"	2	2	0
"528003"	"Jens Jacobs GmbH"	"12.999.01.003"	1	0	1
"528226"	"Rotor Clip"	"12.999.01.003"	-71	0	-71
"528226"	"Rotor Clip"	"12.999.01.008"	26	0	26
"528272"	"Pagenkopf Fahrzeugtechnik"	"12.999.01.001"	10	0	10
"528272"	"Pagenkopf Fahrzeugtechnik"	"12.999.01.003"	14	0	14
"528585"	"AUTO BRAND S.R.L."	"12.999.01.001"	0	0	0
"528585"	"AUTO BRAND S.R.L."	"12.999.01.003"	0	0	0
"528585"	"AUTO BRAND S.R.L."	"12.999.01.008"	0	0	0
"528653"	"FVG GmbH & Co. KG"	"12.999.01.001"	16	5	11
"528653"	"FVG GmbH & Co. KG"	"12.999.01.003"	6	1	5
"528653"	"FVG GmbH & Co. KG"	"12.999.01.162"	4	0	4
"528653"	"FVG GmbH & Co. KG"	"12.999.01.163"	1	0	1
"528693"	"Profi-Parts"	"12.999.01.001"	0	0	0
"528771"	"Zanner Fahrzeugbau GmbH"	"12.999.01.001"	0	0	0
"528771"	"Zanner Fahrzeugbau GmbH"	"12.999.01.003"	0	0	0
"528940"	"F.X. MEILLER GmbH & Co. KG"	"12.999.01.001"	0	0	0
"528940"	"F.X. MEILLER GmbH & Co. KG"	"12.999.01.003"	0	0	0
"529079"	"sfb Schönebecker Fahrzeugbau GmbH"	"12.999.01.003"	0	0	0
"529163"	"Frimatec Ing. GmbH"	"12.999.01.003"	0	0	0
"529351"	"Bavaria Schweisstechnik"	"12.999.01.001"	112	0	112
"529351"	"Bavaria Schweisstechnik"	"12.999.01.003"	-80	0	-80
"529383"	"Gabler Transport & Handel"	"12.999.01.001"	1	0	1
"529452"	"Agrarvereinigung Darchau e.G."	"12.999.01.001"	1	1	0
"529513"	"DOLL"	"12.999.01.001"	4	12	-8
"529513"	"DOLL"	"12.999.01.003"	25	11	14
"529513"	"DOLL"	"12.999.01.008"	0	0	0
"529513"	"DOLL"	"12.999.01.162"	24	10	14
"529513"	"DOLL"	"12.999.01.163"	10	4	6
"529513"	"DOLL"	"12.999.01.188"	8	1	7
"529520"	"Doll Sachsen GmbH"	"12.999.01.001"	6	6	0
"529520"	"Doll Sachsen GmbH"	"12.999.01.003"	6	5	1
"529520"	"Doll Sachsen GmbH"	"12.999.01.008"	4	2	2
"529520"	"Doll Sachsen GmbH"	"12.999.01.162"	14	14	0
"529520"	"Doll Sachsen GmbH"	"12.999.01.163"	4	4	0
"529520"	"Doll Sachsen GmbH"	"12.999.01.188"	1	0	1
"529551"	"Stefan Kohrs"	"12.999.01.001"	0	0	0
"529666"	"Wilhelm Severt Maschinenbau GmbH"	"12.999.01.001"	0	0	0
"529666"	"Wilhelm Severt Maschinenbau GmbH"	"12.999.01.003"	0	0	0
"529734"	"Max Streicher GmbH & Co."	"12.999.01.001"	2	0	2
"529741"	"Firestone Industrial Products"	"12.999.01.001"	105	90	15
"529864"	"WEISSENBURG Industrie-Technik"	"12.999.01.003"	3	0	3
"529894"	"Freidrich Kraft GmbH"	"12.999.01.001"	0	0	0
"529894"	"Freidrich Kraft GmbH"	"12.999.01.003"	0	0	0
"529947"	"Haas Fahrzeugtechnik GmbH"	"12.999.01.003"	0	0	0
"529985"	"Luhn & Pulvermacher"	"12.999.01.001"	21	0	21
"529986"	"LEISE GMBH & CO. KG"	"12.999.01.001"	0	0	0
"530076"	"Dreher und Schulz GbR"	"12.999.01.001"	0	0	0
"530172"	"GOTRADE L.L.C."	"12.999.01.003"	0	0	0
"530183"	"Hermann Fliess & Co. GmbH"	"12.999.01.003"	-16	20	-36
"530310"	"Josef König-Krölleke"	"12.999.01.001"	0	0	0
"530332"	"ITL Fahrzeugbau GmbH"	"12.999.01.001"	2	2	0
"530332"	"ITL Fahrzeugbau GmbH"	"12.999.01.003"	1	1	0
"530333"	"Monroe Czechia S.R.O."	"12.999.01.001"	156	90	66
"530338"	"BWO"	"12.999.01.001"	132	31	101
"530338"	"BWO"	"12.999.01.003"	-19	4	-23
"530338"	"BWO"	"12.999.01.008"	0	10	-10
"530356"	"Autohaus Widmann"	"12.999.01.001"	0	0	0
"530356"	"Autohaus Widmann"	"12.999.01.003"	0	0	0
"530536"	"MAT Commercial Vehicle"	"12.999.01.001"	-3	0	-3
"530536"	"MAT Commercial Vehicle"	"12.999.01.003"	16	1	15
"530536"	"MAT Commercial Vehicle"	"12.999.01.008"	76	2	74
"530621"	"Schenker (D) AG - Zebel (H)"	"12.999.01.008"	0	0	0
"530652"	"Waeles Nederland BV"	"12.999.01.001"	-33	0	-33
"530655"	"Walter Denoth"	"12.999.01.001"	0	0	0
"530720"	"Bernd Glücks"	"12.999.01.001"	0	0	0
"530761"	"Matthias Kühl"	"12.999.01.001"	0	0	0
"530761"	"Matthias Kühl"	"12.999.01.003"	0	0	0
"530813"	"Sievering"	"12.999.01.001"	0	0	0
"530901"	"Kammerer-Reifen GmbH"	"12.999.01.001"	1	0	1
"530901"	"Kammerer-Reifen GmbH"	"12.999.01.003"	1	0	1
"530908"	"HIL GmbH StPkt Oberviechtach"	"12.999.01.001"	0	0	0
"530946"	"AL-KO Record S.A."	"12.999.01.001"	42	0	42
"530959"	"Hofgut Elbaue"	"12.999.01.001"	0	0	0
"530959"	"Hofgut Elbaue"	"12.999.01.003"	0	0	0
"530959"	"Hofgut Elbaue"	"12.999.01.008"	0	0	0
"530964"	"Peter's Transporte u. Montagen GmbH"	"12.999.01.001"	1	0	1
"530964"	"Peter's Transporte u. Montagen GmbH"	"12.999.01.003"	5	0	5
"530984"	"Weigelt"	"12.999.01.001"	0	1	-1
"530984"	"Weigelt"	"12.999.01.003"	0	1	-1
"531030"	"Bandis & Knopp GmbH & Co. KG"	"12.999.01.003"	-56	0	-56
"531047"	"BASE VIE LGV GUINTOLI"	"12.999.01.003"	0	0	0
"531095"	"Agrargenossenschaft "Moorgrund" e.G"	"12.999.01.003"	0	0	0
"531150"	"KTH Trailer GmbH"	"12.999.01.003"	0	0	0
"531239"	"HKM Fahrzeugbau GmbH i. I."	"12.999.01.001"	0	0	0
"531239"	"HKM Fahrzeugbau GmbH i. I."	"12.999.01.003"	0	0	0
"531239"	"HKM Fahrzeugbau GmbH i. I."	"12.999.01.162"	0	0	0
"531239"	"HKM Fahrzeugbau GmbH i. I."	"12.999.01.163"	0	0	0
"531239"	"HKM Fahrzeugbau GmbH i. I."	"12.999.01.188"	0	0	0
"531247"	"WIHAG Fahrzeugsysteme GmbH"	"12.999.01.003"	4	2	2
"531252"	"Fortuna Fahrzeugbau GmbH & Co. KG"	"12.999.01.003"	4	0	4
"531285"	"A.-W. HEIL & SOHN GMBH & CO.KG"	"12.999.01.001"	38	38	0
"531285"	"A.-W. HEIL & SOHN GMBH & CO.KG"	"12.999.01.003"	11	11	0
"531366"	"4JET Technologies GmbH"	"12.999.01.001"	2	2	0
"90000106"	"Saint-Gobain Performance"	"12.999.01.003"	0	0	0
"90000116"	"MANNSTAEDT GMBH"	"12.999.01.003"	1	1	0
"90000187"	"FRAMUER-HALBACH GMBH"	"12.999.01.001"	-1	0	-1
"90000193"	"Trelleborg Sealing Solutions"	"12.999.01.003"	-1	0	-1
"90000267"	"Subtil GmbH"	"12.999.01.003"	-19	0	-19
"90000321"	"ZF Friedrichshafen AG"	"12.999.01.001"	1	0	1
"90000337"	"Leist Oberflächentechnik e.K."	"12.999.01.003"	1	0	1
"90000337"	"Leist Oberflächentechnik e.K."	"12.999.01.008"	3	0	3
"90000356"	"KARL GROLL GMBH & CO. KG"	"12.999.01.001"	2	2	0
"90000388"	"DOLEZYCH GMBH & CO. KG"	"12.999.01.001"	-2	0	-2
"90000389"	"Schaublin S.A."	"12.999.01.003"	0	2	-2
"90000549"	"INTRA Logistik- und"	"12.999.01.003"	0	0	0
