"Kunden Nr."	"Kunde"	"Material Nr."	Anfangsbestand	Retourniert	Zu berechnen
"100010"	"BPW ITALIA S.R.L."	"12.999.01.001"	228	139	89
"100010"	"BPW ITALIA S.R.L."	"12.999.01.003"	1	217	-216
"100010"	"BPW ITALIA S.R.L."	"12.999.01.008"	-169	5	-174
"100010"	"BPW ITALIA S.R.L."	"12.999.01.188"	294	163	131
"100013"	"BPW ITALIA S.R.L."	"12.999.01.003"	14	35	-21
"100014"	"BPW EJES ESPAÑA, S.A."	"12.999.01.188"	6	0	6
"100015"	"FOMA"	"12.999.01.001"	0	1	-1
"100015"	"FOMA"	"12.999.01.003"	332	108	224
"100016"	"BPW KRAATZ OY"	"12.999.01.003"	488	185	303
"100016"	"BPW KRAATZ OY"	"12.999.01.008"	5	0	5
"100016"	"BPW KRAATZ OY"	"12.999.01.188"	106	36	70
"100018"	"TRANSPORT-TEKNIK A/S"	"12.999.01.003"	137	40	97
"100020"	"FAHRZEUGBEDARF AG"	"12.999.01.001"	1	0	1
"100020"	"FAHRZEUGBEDARF AG"	"12.999.01.003"	17	0	17
"100020"	"FAHRZEUGBEDARF AG"	"12.999.01.008"	5	0	5
"100021"	"BPW Hofstad A/S"	"12.999.01.003"	2	0	2
"100021"	"BPW Hofstad A/S"	"12.999.01.008"	2	0	2
"100023"	"BPW Polska Sp. z o.o."	"12.999.01.001"	5	3	2
"100023"	"BPW Polska Sp. z o.o."	"12.999.01.003"	15	2	13
"100023"	"BPW Polska Sp. z o.o."	"12.999.01.188"	14	39	-25
"100024"	"BPW spol. s.r.o."	"12.999.01.001"	2	0	2
"100024"	"BPW spol. s.r.o."	"12.999.01.003"	2	0	2
"100025"	"BPW-HUNGARIA KFT."	"12.999.01.001"	3	2705	-2702
"100025"	"BPW-HUNGARIA KFT."	"12.999.01.003"	-222	2461	-2683
"100025"	"BPW-HUNGARIA KFT."	"12.999.01.008"	2	1860	-1858
"100025"	"BPW-HUNGARIA KFT."	"12.999.01.011"	-5	0	-5
"100025"	"BPW-HUNGARIA KFT."	"12.999.01.162"	3	1409	-1406
"100025"	"BPW-HUNGARIA KFT."	"12.999.01.163"	298	306	-8
"100025"	"BPW-HUNGARIA KFT."	"12.999.01.165"	0	28	-28
"100025"	"BPW-HUNGARIA KFT."	"12.999.01.188"	-7	512	-519
"100029"	"HBN-TEKNIK A/S"	"12.999.01.001"	3	0	3
"100030"	"BPW TRAPACO S.L."	"12.999.01.001"	2	2	0
"100030"	"BPW TRAPACO S.L."	"12.999.01.003"	51	4	47
"100030"	"BPW TRAPACO S.L."	"12.999.01.008"	35	0	35
"100030"	"BPW TRAPACO S.L."	"12.999.01.162"	32	0	32
"100030"	"BPW TRAPACO S.L."	"12.999.01.163"	9	0	9
"100030"	"BPW TRAPACO S.L."	"12.999.01.188"	21	5	16
"100032"	"BPW FRANCE SAS"	"12.999.01.001"	74	75	-1
"100032"	"BPW FRANCE SAS"	"12.999.01.003"	8	8	0
"100032"	"BPW FRANCE SAS"	"12.999.01.008"	9	17	-8
"100032"	"BPW FRANCE SAS"	"12.999.01.162"	4	34	-30
"100032"	"BPW FRANCE SAS"	"12.999.01.163"	1	6	-5
"100032"	"BPW FRANCE SAS"	"12.999.01.188"	467	632	-165
"100035"	"BPW Benelux sprl."	"12.999.01.001"	1	592	-591
"100035"	"BPW Benelux sprl."	"12.999.01.003"	118	180	-62
"100035"	"BPW Benelux sprl."	"12.999.01.008"	194	52	142
"100035"	"BPW Benelux sprl."	"12.999.01.162"	523	64	459
"100035"	"BPW Benelux sprl."	"12.999.01.163"	108	23	85
"100035"	"BPW Benelux sprl."	"12.999.01.165"	6	0	6
"100035"	"BPW Benelux sprl."	"12.999.01.188"	203	380	-177
"100036"	"Busch - Hungaria Kft."	"12.999.01.001"	428	1993	-1565
"100036"	"Busch - Hungaria Kft."	"12.999.01.003"	-115	0	-115
"100043"	"Besko A/S"	"12.999.01.003"	167	22	145
"100048"	"Släpis AB"	"12.999.01.003"	64	64	0
"100071"	"BPW AXLES (PTY) LTD."	"12.999.01.003"	0	1	-1
"210118"	"ASCHWEGE & TOENJES GMBH"	"12.999.01.001"	4	3	1
"210118"	"ASCHWEGE & TOENJES GMBH"	"12.999.01.162"	0	0	0
"210118"	"ASCHWEGE & TOENJES GMBH"	"12.999.01.163"	0	0	0
"210118"	"ASCHWEGE & TOENJES GMBH"	"12.999.01.188"	1	0	1
"210234"	"LUDWIG BERGMANN GMBH"	"12.999.01.001"	2	1	1
"210247"	"Blomenröhr Fahrzeugbau GmbH"	"12.999.01.001"	2	2	0
"210247"	"Blomenröhr Fahrzeugbau GmbH"	"12.999.01.003"	8	8	0
"210250"	"Bagela Baumaschinen GmbH & Co.KG"	"12.999.01.001"	0	0	0
"210305"	"Carnehl Fahrzeugbau"	"12.999.01.001"	55	21	34
"210305"	"Carnehl Fahrzeugbau"	"12.999.01.003"	13	32	-19
"210305"	"Carnehl Fahrzeugbau"	"12.999.01.008"	15	8	7
"210305"	"Carnehl Fahrzeugbau"	"12.999.01.162"	44	0	44
"210305"	"Carnehl Fahrzeugbau"	"12.999.01.163"	11	0	11
"210305"	"Carnehl Fahrzeugbau"	"12.999.01.188"	27	12	15
"210507"	"EGGERS"	"12.999.01.001"	1	3	-2
"210507"	"EGGERS"	"12.999.01.003"	0	1	-1
"210507"	"EGGERS"	"12.999.01.008"	0	2	-2
"210507"	"EGGERS"	"12.999.01.162"	0	8	-8
"210507"	"EGGERS"	"12.999.01.163"	0	2	-2
"210507"	"EGGERS"	"12.999.01.188"	1	1	0
"210602"	"FELDBINDER"	"12.999.01.001"	68	35	33
"210602"	"FELDBINDER"	"12.999.01.003"	-18	3	-21
"210602"	"FELDBINDER"	"12.999.01.008"	7	21	-14
"210602"	"FELDBINDER"	"12.999.01.162"	7	4	3
"210602"	"FELDBINDER"	"12.999.01.163"	2	1	1
"210602"	"FELDBINDER"	"12.999.01.188"	90	69	21
"210613"	"WILHELM FRICKE GMBH"	"12.999.01.001"	1	6	-5
"210613"	"WILHELM FRICKE GMBH"	"12.999.01.003"	0	3	-3
"210613"	"WILHELM FRICKE GMBH"	"12.999.01.008"	0	0	0
"210818"	"Hofmeister & Meincke GmbH & Co. KG"	"12.999.01.001"	17	10	7
"210818"	"Hofmeister & Meincke GmbH & Co. KG"	"12.999.01.003"	-53	7	-60
"210818"	"Hofmeister & Meincke GmbH & Co. KG"	"12.999.01.008"	0	0	0
"210833"	"A.-W. HEIL & SOHN GMBH & CO.KG"	"12.999.01.001"	38	38	0
"210833"	"A.-W. HEIL & SOHN GMBH & CO.KG"	"12.999.01.003"	11	11	0
"210845"	"HEINRICH HEUSER GMBH & CO. KG"	"12.999.01.001"	1	1	0
"210845"	"HEINRICH HEUSER GMBH & CO. KG"	"12.999.01.188"	1	1	0
"210846"	"Heitling Fahrzeugbau GmbH & Co. KG"	"12.999.01.001"	0	0	0
"210846"	"Heitling Fahrzeugbau GmbH & Co. KG"	"12.999.01.188"	1	1	0
"210849"	"HRD-TRAILER-ENGINEERING GMBH"	"12.999.01.001"	18	27	-9
"210849"	"HRD-TRAILER-ENGINEERING GMBH"	"12.999.01.003"	6	7	-1
"210849"	"HRD-TRAILER-ENGINEERING GMBH"	"12.999.01.008"	9	6	3
"210849"	"HRD-TRAILER-ENGINEERING GMBH"	"12.999.01.162"	14	8	6
"210849"	"HRD-TRAILER-ENGINEERING GMBH"	"12.999.01.163"	12	9	3
"210849"	"HRD-TRAILER-ENGINEERING GMBH"	"12.999.01.188"	-1	1	-2
"211005"	"OTTO JUST GMBH & CO. KG"	"12.999.01.001"	0	0	0
"211108"	"Köhler Fahrzeugbau GmbH & Co.KG"	"12.999.01.001"	0	0	0
"211108"	"Köhler Fahrzeugbau GmbH & Co.KG"	"12.999.01.003"	0	0	0
"211108"	"Köhler Fahrzeugbau GmbH & Co.KG"	"12.999.01.188"	0	0	0
"211122"	"EMMY KLOOSS"	"12.999.01.001"	1	4	-3
"211123"	"PETER KROEGER GMBH"	"12.999.01.003"	0	1	-1
"211130"	"Josef Kotte"	"12.999.01.001"	2	3	-1
"211130"	"Josef Kotte"	"12.999.01.003"	0	0	0
"211130"	"Josef Kotte"	"12.999.01.188"	1	1	0
"211133"	"KRUKENMEIER GMBH"	"12.999.01.001"	8	8	0
"211133"	"KRUKENMEIER GMBH"	"12.999.01.003"	6	6	0
"211133"	"KRUKENMEIER GMBH"	"12.999.01.162"	0	0	0
"211133"	"KRUKENMEIER GMBH"	"12.999.01.163"	0	0	0
"211133"	"KRUKENMEIER GMBH"	"12.999.01.188"	1	0	1
"211134"	"KAR KUNZ"	"12.999.01.001"	-3	1	-4
"211134"	"KAR KUNZ"	"12.999.01.003"	4	2	2
"211136"	"Kedrowski Fahrzeugbau GmbH & Co. KG"	"12.999.01.001"	0	0	0
"211136"	"Kedrowski Fahrzeugbau GmbH & Co. KG"	"12.999.01.003"	0	0	0
"211214"	"LAHRS GmbH & Co. KG"	"12.999.01.003"	1	0	1
"211214"	"LAHRS GmbH & Co. KG"	"12.999.01.188"	1	0	1
"211325"	"MENKE-JANZEN"	"12.999.01.001"	36	6	30
"211325"	"MENKE-JANZEN"	"12.999.01.003"	-12	1	-13
"211325"	"MENKE-JANZEN"	"12.999.01.162"	0	0	0
"211325"	"MENKE-JANZEN"	"12.999.01.163"	0	0	0
"211325"	"MENKE-JANZEN"	"12.999.01.188"	7	6	1
"211327"	"Moetefindt Fahrzeugbau"	"12.999.01.001"	1	1	0
"211327"	"Moetefindt Fahrzeugbau"	"12.999.01.003"	2	2	0
"211330"	"MEYER - LOHNE GMBH"	"12.999.01.001"	0	0	0
"211335"	"MEINDL"	"12.999.01.001"	1	1	0
"211335"	"MEINDL"	"12.999.01.003"	1	1	0
"211613"	"PV Automotive GmbH"	"12.999.01.001"	0	0	0
"211613"	"PV Automotive GmbH"	"12.999.01.003"	0	0	0
"211802"	"RUDOLF RANCKE"	"12.999.01.003"	0	1	-1
"211813"	"Reiling Nutzfahrzeugservice GmbH"	"12.999.01.001"	0	0	0
"211906"	"SPIER  GMBH & CO."	"12.999.01.001"	2	5	-3
"211906"	"SPIER  GMBH & CO."	"12.999.01.003"	2	4	-2
"211906"	"SPIER  GMBH & CO."	"12.999.01.008"	6	0	6
"211906"	"SPIER  GMBH & CO."	"12.999.01.162"	4	0	4
"211906"	"SPIER  GMBH & CO."	"12.999.01.163"	0	0	0
"211906"	"SPIER  GMBH & CO."	"12.999.01.188"	0	1	-1
"211912"	"Ludwig Südbeck Nutzfahrzeuge GmbH"	"12.999.01.001"	0	0	0
"211915"	"JUERGEN STERN"	"12.999.01.001"	0	0	0
"212004"	"SCHROEDER"	"12.999.01.001"	1	1	0
"212004"	"SCHROEDER"	"12.999.01.003"	0	0	0
"212004"	"SCHROEDER"	"12.999.01.162"	0	0	0
"212004"	"SCHROEDER"	"12.999.01.163"	0	0	0
"212004"	"SCHROEDER"	"12.999.01.188"	0	0	0
"212010"	"SCHUETTE FAHRZEUGBAU GMBH"	"12.999.01.001"	0	1	-1
"212010"	"SCHUETTE FAHRZEUGBAU GMBH"	"12.999.01.003"	0	1	-1
"212012"	"KFB Jessen GmbH"	"12.999.01.001"	2	0	2
"212012"	"KFB Jessen GmbH"	"12.999.01.003"	2	0	2
"212020"	"E. SCHWAGMEIER KAROSSERIE- UND"	"12.999.01.001"	0	0	0
"212020"	"E. SCHWAGMEIER KAROSSERIE- UND"	"12.999.01.003"	0	0	0
"212109"	"Stehmann GmbH"	"12.999.01.001"	3	3	0
"212109"	"Stehmann GmbH"	"12.999.01.003"	1	1	0
"212109"	"Stehmann GmbH"	"12.999.01.188"	2	1	1
"212110"	"METALLBAU STAGGENBORG GMBH"	"12.999.01.001"	-4	1	-5
"212110"	"METALLBAU STAGGENBORG GMBH"	"12.999.01.003"	2	0	2
"212209"	"HERMANN TECHAU"	"12.999.01.001"	0	0	0
"212213"	"TOS TWIST"	"12.999.01.001"	1	1	0
"212215"	"Jacob Thaler GmbH"	"12.999.01.001"	2	2	0
"212504"	"Lely Vermeer"	"12.999.01.003"	1	0	1
"212504"	"Lely Vermeer"	"12.999.01.008"	2	0	2
"212508"	"WABCO GmbH & Co. OHG"	"12.999.01.001"	-6	5	-11
"212527"	"Wiese GmbH & Co. KG"	"12.999.01.001"	2	1	1
"212527"	"Wiese GmbH & Co. KG"	"12.999.01.003"	1	1	0
"212527"	"Wiese GmbH & Co. KG"	"12.999.01.188"	3	0	3
"212528"	"WILKEN"	"12.999.01.003"	1	1	0
"212528"	"WILKEN"	"12.999.01.188"	8	9	-1
"212532"	"WIENHOFF"	"12.999.01.001"	2	2	0
"212534"	"Heinrich Wellmeyer Fahrzeugbau"	"12.999.01.001"	6	4	2
"212534"	"Heinrich Wellmeyer Fahrzeugbau"	"12.999.01.162"	4	0	4
"212534"	"Heinrich Wellmeyer Fahrzeugbau"	"12.999.01.163"	1	0	1
"212534"	"Heinrich Wellmeyer Fahrzeugbau"	"12.999.01.188"	10	3	7
"212535"	"Weka Fahrzeugbau GmbH"	"12.999.01.001"	41	6	35
"212535"	"Weka Fahrzeugbau GmbH"	"12.999.01.003"	1	2	-1
"212535"	"Weka Fahrzeugbau GmbH"	"12.999.01.008"	0	0	0
"212535"	"Weka Fahrzeugbau GmbH"	"12.999.01.162"	0	0	0
"212535"	"Weka Fahrzeugbau GmbH"	"12.999.01.163"	0	0	0
"212535"	"Weka Fahrzeugbau GmbH"	"12.999.01.188"	14	7	7
"220116"	"ATV-ELMER GMBH & CO. KG"	"12.999.01.001"	2	0	2
"220116"	"ATV-ELMER GMBH & CO. KG"	"12.999.01.003"	2	0	2
"220118"	"AMAZONEN-WERKE"	"12.999.01.001"	10	0	10
"220118"	"AMAZONEN-WERKE"	"12.999.01.003"	5	2	3
"220118"	"AMAZONEN-WERKE"	"12.999.01.008"	5	2	3
"220204"	"Bierhake Fahrzeugteile"	"12.999.01.001"	0	1	-1
"220205"	"Bierhake Fahrzeugteile"	"12.999.01.001"	2	5	-3
"220205"	"Bierhake Fahrzeugteile"	"12.999.01.003"	1	1	0
"220228"	"Bohnenkamp AG"	"12.999.01.001"	5	0	5
"220228"	"Bohnenkamp AG"	"12.999.01.003"	1	1	0
"220252"	"PAUL BRUESER GMBH"	"12.999.01.001"	-1	48	-49
"220252"	"PAUL BRUESER GMBH"	"12.999.01.003"	-3	125	-128
"220252"	"PAUL BRUESER GMBH"	"12.999.01.008"	460	471	-11
"220252"	"PAUL BRUESER GMBH"	"12.999.01.011"	3	0	3
"220254"	"BWO BEHINDERTEN-WERKSTAETTEN"	"12.999.01.001"	-30	49	-79
"220254"	"BWO BEHINDERTEN-WERKSTAETTEN"	"12.999.01.003"	98	49	49
"220254"	"BWO BEHINDERTEN-WERKSTAETTEN"	"12.999.01.008"	111	184	-73
"220255"	"BWO BEHINDERTEN-WERSTAETTEN"	"12.999.01.001"	-6	139	-145
"220255"	"BWO BEHINDERTEN-WERSTAETTEN"	"12.999.01.003"	4	61	-57
"220255"	"BWO BEHINDERTEN-WERSTAETTEN"	"12.999.01.008"	26	84	-58
"220312"	"MANNSTAEDT GMBH & CO. KG"	"12.999.01.001"	17	18	-1
"220312"	"MANNSTAEDT GMBH & CO. KG"	"12.999.01.003"	2	0	2
"220414"	"FAHRZEUGBAU DRUMANN GMBH"	"12.999.01.001"	1	1	0
"220414"	"FAHRZEUGBAU DRUMANN GMBH"	"12.999.01.003"	0	0	0
"220414"	"FAHRZEUGBAU DRUMANN GMBH"	"12.999.01.188"	1	1	0
"220510"	"EUROPART Trading GmbH"	"12.999.01.003"	0	1	-1
"220523"	"EUROPART  Trading GmbH"	"12.999.01.001"	0	1	-1
"220628"	"FONTANA GMBH"	"12.999.01.003"	-300	34	-334
"220628"	"FONTANA GMBH"	"12.999.01.008"	521	91	430
"220629"	"GEORG FISCHER GMBH & CO. KG"	"12.999.01.001"	-7	0	-7
"220629"	"GEORG FISCHER GMBH & CO. KG"	"12.999.01.003"	-9	0	-9
"220703"	"GOFA Gocher Fahrzeugbau GmbH"	"12.999.01.001"	12	2	10
"220703"	"GOFA Gocher Fahrzeugbau GmbH"	"12.999.01.003"	6	2	4
"220703"	"GOFA Gocher Fahrzeugbau GmbH"	"12.999.01.008"	1	0	1
"220703"	"GOFA Gocher Fahrzeugbau GmbH"	"12.999.01.162"	4	0	4
"220703"	"GOFA Gocher Fahrzeugbau GmbH"	"12.999.01.188"	11	8	3
"220814"	"Beilharz Nutzfahrzeuge"	"12.999.01.001"	0	0	0
"220814"	"Beilharz Nutzfahrzeuge"	"12.999.01.003"	0	0	0
"220831"	"AUTOTEILE HERRMANN GMBH"	"12.999.01.001"	1	1	0
"220843"	"HEETMANN & FINKENSIEP"	"12.999.01.003"	5	111	-106
"220843"	"HEETMANN & FINKENSIEP"	"12.999.01.008"	220	360	-140
"221113"	"Fahrzeugwerk Bernard Krone GmbH"	"12.999.01.001"	716	1002	-286
"221113"	"Fahrzeugwerk Bernard Krone GmbH"	"12.999.01.003"	66	69	-3
"221113"	"Fahrzeugwerk Bernard Krone GmbH"	"12.999.01.008"	91	114	-23
"221113"	"Fahrzeugwerk Bernard Krone GmbH"	"12.999.01.162"	54	464	-410
"221113"	"Fahrzeugwerk Bernard Krone GmbH"	"12.999.01.163"	26	124	-98
"221113"	"Fahrzeugwerk Bernard Krone GmbH"	"12.999.01.188"	286	1992	-1706
"221114"	"KLAESER INTERN. FACHSPEDITION"	"12.999.01.001"	7	3	4
"221114"	"KLAESER INTERN. FACHSPEDITION"	"12.999.01.003"	9	3	6
"221114"	"KLAESER INTERN. FACHSPEDITION"	"12.999.01.188"	2	0	2
"221126"	"Kroll Fahrzeugbau-"	"12.999.01.001"	0	0	0
"221126"	"Kroll Fahrzeugbau-"	"12.999.01.003"	0	0	0
"221155"	"KRAMPE"	"12.999.01.001"	1	1	0
"221155"	"KRAMPE"	"12.999.01.003"	2	2	0
"221207"	"LEVEN NUTZFAHRZEUGE"	"12.999.01.001"	3	4	-1
"221207"	"LEVEN NUTZFAHRZEUGE"	"12.999.01.003"	0	0	0
"221213"	"Hermann Langfeld e.K."	"12.999.01.001"	4	1	3
"221213"	"Hermann Langfeld e.K."	"12.999.01.003"	0	0	0
"221213"	"Hermann Langfeld e.K."	"12.999.01.188"	4	1	3
"221214"	"LOECHTERFELD GMBH"	"12.999.01.001"	9	9	0
"221214"	"LOECHTERFELD GMBH"	"12.999.01.003"	5	5	0
"221221"	"LANCIER CABLE GMBH"	"12.999.01.001"	0	0	0
"221229"	"LEMKEN GMBH & CO. KG"	"12.999.01.001"	1	1	0
"221229"	"LEMKEN GMBH & CO. KG"	"12.999.01.008"	0	0	0
"221233"	"LANGENDORF GmbH"	"12.999.01.001"	189	119	70
"221233"	"LANGENDORF GmbH"	"12.999.01.003"	20	27	-7
"221233"	"LANGENDORF GmbH"	"12.999.01.008"	34	48	-14
"221233"	"LANGENDORF GmbH"	"12.999.01.162"	-2	8	-10
"221233"	"LANGENDORF GmbH"	"12.999.01.163"	2	2	0
"221233"	"LANGENDORF GmbH"	"12.999.01.188"	49	42	7
"221309"	"ANHAENGER- U. FAHRZEUGBAU"	"12.999.01.001"	6	4	2
"221309"	"ANHAENGER- U. FAHRZEUGBAU"	"12.999.01.008"	1	0	1
"221309"	"ANHAENGER- U. FAHRZEUGBAU"	"12.999.01.188"	3	2	1
"221404"	"NTV NUTZFAHRZEUGTEILE"	"12.999.01.001"	21	21	0
"221404"	"NTV NUTZFAHRZEUGTEILE"	"12.999.01.003"	11	11	0
"221506"	"OSTERATH GMBH"	"12.999.01.001"	1	0	1
"221506"	"OSTERATH GMBH"	"12.999.01.003"	2	0	2
"221609"	"PV Automotive GmbH"	"12.999.01.003"	1	0	1
"221610"	"PV Automotive GmbH"	"12.999.01.001"	43	32	11
"221610"	"PV Automotive GmbH"	"12.999.01.003"	10	8	2
"221806"	"Fahrzeugbau Robert GmbH"	"12.999.01.001"	1	1	0
"221806"	"Fahrzeugbau Robert GmbH"	"12.999.01.003"	1	1	0
"221813"	"GEBR. RECKER GMBH"	"12.999.01.001"	0	0	0
"221813"	"GEBR. RECKER GMBH"	"12.999.01.162"	4	0	4
"221813"	"GEBR. RECKER GMBH"	"12.999.01.163"	1	0	1
"221815"	"RI-FA"	"12.999.01.001"	0	9	-9
"221815"	"RI-FA"	"12.999.01.003"	0	0	0
"221907"	"SUER NUTZFAHRZEUGTECHNIK Gmbh & Co"	"12.999.01.001"	0	0	0
"221921"	"SIEPMANN-WERKE"	"12.999.01.001"	-1	0	-1
"222002"	"August Schmidt GmbH & Co. KG"	"12.999.01.001"	5	6	-1
"222002"	"August Schmidt GmbH & Co. KG"	"12.999.01.003"	6	6	0
"222002"	"August Schmidt GmbH & Co. KG"	"12.999.01.008"	0	0	0
"222002"	"August Schmidt GmbH & Co. KG"	"12.999.01.188"	11	2	9
"222019"	"SCHMIDT KRAFTFAHRZEUG-"	"12.999.01.001"	5	15	-10
"222019"	"SCHMIDT KRAFTFAHRZEUG-"	"12.999.01.003"	0	0	0
"222027"	"WILLI SCHOLZ GMBH & CO. KG"	"12.999.01.003"	0	0	0
"222030"	"SCHMITZ-CARGOBULL AG"	"12.999.01.001"	5	7	-2
"222030"	"SCHMITZ-CARGOBULL AG"	"12.999.01.003"	-17	0	-17
"222030"	"SCHMITZ-CARGOBULL AG"	"12.999.01.188"	5	14	-9
"222032"	"SCHMITZ-CARGOBULL AG"	"12.999.01.001"	8	25	-17
"222032"	"SCHMITZ-CARGOBULL AG"	"12.999.01.003"	-7	1	-8
"222032"	"SCHMITZ-CARGOBULL AG"	"12.999.01.008"	1	0	1
"222032"	"SCHMITZ-CARGOBULL AG"	"12.999.01.188"	70	96	-26
"222037"	"SCHRADER-T + A + Fahrzeugbau"	"12.999.01.001"	9	9	0
"222037"	"SCHRADER-T + A + Fahrzeugbau"	"12.999.01.008"	1	0	1
"222037"	"SCHRADER-T + A + Fahrzeugbau"	"12.999.01.188"	20	17	3
"222042"	"SCHMIEDAG GMBH"	"12.999.01.001"	11	0	11
"222107"	"STAPEL GMBH"	"12.999.01.001"	0	1	-1
"222204"	"GEBR. TITGEMEYER GMBH & CO. KG"	"12.999.01.001"	0	1	-1
"222204"	"GEBR. TITGEMEYER GMBH & CO. KG"	"12.999.01.003"	0	1	-1
"222216"	"Albert Tebbe GmbH"	"12.999.01.001"	0	0	0
"222216"	"Albert Tebbe GmbH"	"12.999.01.003"	0	0	0
"222540"	"WINKLER FAHRZEUGTEILE GMBH"	"12.999.01.001"	0	0	0
"222543"	"WECON"	"12.999.01.001"	18	4	14
"222543"	"WECON"	"12.999.01.003"	8	8	0
"222543"	"WECON"	"12.999.01.008"	5	0	5
"222543"	"WECON"	"12.999.01.162"	2	0	2
"222543"	"WECON"	"12.999.01.165"	2	0	2
"222543"	"WECON"	"12.999.01.188"	5	1	4
"222547"	"W+O NIETTECHNIK GMBH"	"12.999.01.001"	1	0	1
"222547"	"W+O NIETTECHNIK GMBH"	"12.999.01.003"	84	0	84
"222547"	"W+O NIETTECHNIK GMBH"	"12.999.01.008"	208	0	208
"223001"	"SCHOMAECKER FEDERNWERK GMBH"	"12.999.01.001"	71	0	71
"223001"	"SCHOMAECKER FEDERNWERK GMBH"	"12.999.01.003"	-186	663	-849
"223008"	"Rütgers GmbH & Co. KG"	"12.999.01.001"	0	0	0
"223008"	"Rütgers GmbH & Co. KG"	"12.999.01.003"	0	0	0
"223017"	"WESTFALEN AG"	"12.999.01.001"	0	1	-1
"230000"	"BPW Bergische Achsen"	"12.999.01.001"	23	4	19
"230000"	"BPW Bergische Achsen"	"12.999.01.003"	56	18	38
"230000"	"BPW Bergische Achsen"	"12.999.01.008"	5	1	4
"240213"	"BERGER KAROSSERIE-"	"12.999.01.001"	0	0	0
"240213"	"BERGER KAROSSERIE-"	"12.999.01.003"	0	0	0
"240240"	"Benninghoven GmbH & Co KG"	"12.999.01.003"	5	0	5
"240304"	"CHRISTMANN-FAHRZEUGBAU"	"12.999.01.003"	1	1	0
"240505"	"DR. ING. ULRICH ESTERER GMBH & CO."	"12.999.01.001"	0	0	0
"240505"	"DR. ING. ULRICH ESTERER GMBH & CO."	"12.999.01.003"	0	0	0
"240518"	"EUROPART"	"12.999.01.001"	0	0	0
"240520"	"EUROPART  Trading GMBH"	"12.999.01.001"	0	0	0
"240522"	"EISEL NUTZFAHRZEUGE GMBH"	"12.999.01.001"	1	1	0
"240522"	"EISEL NUTZFAHRZEUGE GMBH"	"12.999.01.003"	1	1	0
"240522"	"EISEL NUTZFAHRZEUGE GMBH"	"12.999.01.188"	0	1	-1
"240632"	"Fischer Fahrzeugbau GmbH"	"12.999.01.001"	1	0	1
"240733"	"GANGOLF NUTZFAHRZEUGE GMBH"	"12.999.01.001"	2	0	2
"240827"	"HEURICH"	"12.999.01.001"	0	0	0
"240827"	"HEURICH"	"12.999.01.003"	0	0	0
"240836"	"HAGE, KNAPP & CO."	"12.999.01.001"	3	2	1
"240836"	"HAGE, KNAPP & CO."	"12.999.01.003"	1	1	0
"240836"	"HAGE, KNAPP & CO."	"12.999.01.188"	1	0	1
"241008"	"Jost  Werke GmbH"	"12.999.01.001"	-118	5	-123
"241008"	"Jost  Werke GmbH"	"12.999.01.003"	-1	0	-1
"241114"	"ERICH KERSTING GMBH & CO. KG"	"12.999.01.001"	1	2	-1
"241114"	"ERICH KERSTING GMBH & CO. KG"	"12.999.01.003"	0	0	0
"241134"	"Fahrzeugbau Kempf GmbH"	"12.999.01.001"	83	90	-7
"241134"	"Fahrzeugbau Kempf GmbH"	"12.999.01.003"	2	10	-8
"241134"	"Fahrzeugbau Kempf GmbH"	"12.999.01.008"	2	1	1
"241134"	"Fahrzeugbau Kempf GmbH"	"12.999.01.162"	0	0	0
"241134"	"Fahrzeugbau Kempf GmbH"	"12.999.01.163"	0	0	0
"241134"	"Fahrzeugbau Kempf GmbH"	"12.999.01.188"	73	79	-6
"241146"	"KEMPF FAHRZEUGBAU"	"12.999.01.001"	2	0	2
"241146"	"KEMPF FAHRZEUGBAU"	"12.999.01.188"	3	0	3
"241214"	"LUECK FAHRZEUGBAU GMBH"	"12.999.01.001"	3	0	3
"241214"	"LUECK FAHRZEUGBAU GMBH"	"12.999.01.003"	1	0	1
"241214"	"LUECK FAHRZEUGBAU GMBH"	"12.999.01.188"	3	0	3
"241216"	"LEISE GMBH & CO. KG"	"12.999.01.001"	5	9	-4
"241216"	"LEISE GMBH & CO. KG"	"12.999.01.003"	1	1	0
"241217"	"KRAMP Groep B.V."	"12.999.01.001"	1	3	-2
"241328"	"A. MUELLER FAHRZEUGBAU GMBH"	"12.999.01.001"	6	3	3
"241328"	"A. MUELLER FAHRZEUGBAU GMBH"	"12.999.01.003"	5	4	1
"241328"	"A. MUELLER FAHRZEUGBAU GMBH"	"12.999.01.188"	2	0	2
"241349"	"F. MUELLER GMBH & CO. KG"	"12.999.01.003"	1	1	0
"241350"	"MENZER GMBH"	"12.999.01.001"	0	0	0
"241505"	"ORTEN GMBH & CO. KG"	"12.999.01.001"	0	0	0
"241618"	"PROFI PARTS"	"12.999.01.001"	108	9	99
"241618"	"PROFI PARTS"	"12.999.01.003"	-8	0	-8
"241619"	"PROFI PARTS"	"12.999.01.001"	6	2	4
"241620"	"PROFI PARTS"	"12.999.01.001"	1	1	0
"241829"	"ROETTGER"	"12.999.01.001"	0	0	0
"241829"	"ROETTGER"	"12.999.01.003"	0	0	0
"241841"	"Winkler Logistik GmbH"	"12.999.01.001"	0	23	-23
"241841"	"Winkler Logistik GmbH"	"12.999.01.003"	0	17	-17
"242222"	"TROST AUTO SERVICE TECHNIK SE"	"12.999.01.003"	0	1	-1
"242506"	"EUROPART  Trading GMBH"	"12.999.01.001"	1	1	0
"242516"	"WELLER GMBH & CO. KG"	"12.999.01.001"	0	0	0
"242516"	"WELLER GMBH & CO. KG"	"12.999.01.003"	0	0	0
"242516"	"WELLER GMBH & CO. KG"	"12.999.01.008"	0	0	0
"242520"	"HEINRICH WEDEKIND &"	"12.999.01.001"	1	3	-2
"242520"	"HEINRICH WEDEKIND &"	"12.999.01.003"	1	1	0
"250212"	"BIRNER GMBH"	"12.999.01.001"	1	1	0
"250213"	"BISCHOFF + SCHECK AG"	"12.999.01.001"	0	1	-1
"250409"	"DIER & JAKOB"	"12.999.01.001"	0	0	0
"250611"	"FGS GMBH"	"12.999.01.001"	1	1	0
"250807"	"HONOLD GMBH & CO.KG"	"12.999.01.001"	1	0	1
"250807"	"HONOLD GMBH & CO.KG"	"12.999.01.188"	2	0	2
"250822"	"HIRTH FAHRZEUGBAU GMBH"	"12.999.01.001"	1	0	1
"251113"	"KAROSSERIEFABRIK BIBERACH GMBH"	"12.999.01.001"	0	3	-3
"251113"	"KAROSSERIEFABRIK BIBERACH GMBH"	"12.999.01.188"	0	1	-1
"251114"	"KOEPF FAHRZEUGBAU GMBH"	"12.999.01.188"	0	0	0
"251121"	"MASCHINENBAU KALTENBACH GMBH"	"12.999.01.001"	3	3	0
"251121"	"MASCHINENBAU KALTENBACH GMBH"	"12.999.01.003"	2	2	0
"251121"	"MASCHINENBAU KALTENBACH GMBH"	"12.999.01.188"	1	1	0
"251132"	"KAMAG"	"12.999.01.001"	1	1	0
"251132"	"KAMAG"	"12.999.01.003"	0	0	0
"251203"	"LIEBHERR-WERK"	"12.999.01.001"	1	1	0
"251203"	"LIEBHERR-WERK"	"12.999.01.003"	8	8	0
"251203"	"LIEBHERR-WERK"	"12.999.01.008"	1	0	1
"251203"	"LIEBHERR-WERK"	"12.999.01.163"	0	0	0
"251208"	"L + M FAHRZEUGBAU GMBH"	"12.999.01.001"	0	1	-1
"251208"	"L + M FAHRZEUGBAU GMBH"	"12.999.01.003"	0	1	-1
"251208"	"L + M FAHRZEUGBAU GMBH"	"12.999.01.162"	0	0	0
"251208"	"L + M FAHRZEUGBAU GMBH"	"12.999.01.163"	0	0	0
"251302"	"MUENZ FAHRZEUGBAU GMBH & CO.KG"	"12.999.01.003"	0	1	-1
"251306"	"Karl Mueller GmbH & Co. KG"	"12.999.01.001"	11	30	-19
"251306"	"Karl Mueller GmbH & Co. KG"	"12.999.01.003"	25	57	-32
"251306"	"Karl Mueller GmbH & Co. KG"	"12.999.01.008"	1	6	-5
"251306"	"Karl Mueller GmbH & Co. KG"	"12.999.01.162"	0	14	-14
"251306"	"Karl Mueller GmbH & Co. KG"	"12.999.01.163"	0	5	-5
"251306"	"Karl Mueller GmbH & Co. KG"	"12.999.01.188"	2	2	0
"251317"	"MS-PARTS GMBH"	"12.999.01.001"	5	7	-2
"251317"	"MS-PARTS GMBH"	"12.999.01.003"	8	4	4
"251317"	"MS-PARTS GMBH"	"12.999.01.188"	0	0	0
"251405"	"Neumayer Tekfor GmbH"	"12.999.01.001"	56	60	-4
"251405"	"Neumayer Tekfor GmbH"	"12.999.01.003"	100	82	18
"251405"	"Neumayer Tekfor GmbH"	"12.999.01.008"	273	344	-71
"251805"	"Winkler Logistik GmbH"	"12.999.01.001"	14	0	14
"251812"	"Winkler Logistik GmbH"	"12.999.01.001"	194	66	128
"251812"	"Winkler Logistik GmbH"	"12.999.01.003"	63	20	43
"251812"	"Winkler Logistik GmbH"	"12.999.01.008"	1	0	1
"251904"	"SPITZER"	"12.999.01.001"	16	11	5
"251904"	"SPITZER"	"12.999.01.003"	4	0	4
"251904"	"SPITZER"	"12.999.01.162"	4	0	4
"251904"	"SPITZER"	"12.999.01.163"	0	0	0
"251904"	"SPITZER"	"12.999.01.188"	38	29	9
"252018"	"SCHEUERLE"	"12.999.01.001"	5	3	2
"252018"	"SCHEUERLE"	"12.999.01.003"	39	28	11
"252028"	"BREMSEN SCHNEIDER GMBH"	"12.999.01.003"	0	1	-1
"252029"	"AEBI SCHMIDT DEUTSCHLAND GMBH"	"12.999.01.001"	17	2	15
"252029"	"AEBI SCHMIDT DEUTSCHLAND GMBH"	"12.999.01.003"	53	3	50
"252029"	"AEBI SCHMIDT DEUTSCHLAND GMBH"	"12.999.01.008"	1	0	1
"252030"	"Fahrzeugbau Hahn e. K"	"12.999.01.003"	0	1	-1
"252107"	"STAIGER NUTZFAHRZEUGE GMBH"	"12.999.01.001"	1	0	1
"252110"	"AUTOTEILE STREB GMBH"	"12.999.01.001"	1	1	0
"252204"	"TROST AUTO SERVICE TECHNIK SE"	"12.999.01.001"	0	0	0
"252508"	"WINKLER FAHRZEUGTEILE GMBH"	"12.999.01.001"	2	2	0
"252509"	"WINKLER Fahrzeugteile GmbH & Co.KG"	"12.999.01.001"	2	2	0
"252509"	"WINKLER Fahrzeugteile GmbH & Co.KG"	"12.999.01.003"	1	1	0
"252522"	"J. WILLIBALD"	"12.999.01.001"	1	0	1
"252522"	"J. WILLIBALD"	"12.999.01.003"	0	0	0
"252522"	"J. WILLIBALD"	"12.999.01.008"	0	0	0
"252702"	"ZIKUN FAHRZEUGBAU GMBH"	"12.999.01.001"	2	2	0
"252702"	"ZIKUN FAHRZEUGBAU GMBH"	"12.999.01.003"	2	5	-3
"252702"	"ZIKUN FAHRZEUGBAU GMBH"	"12.999.01.188"	7	2	5
"252704"	"GUSTAV ZIEGLER GMBH"	"12.999.01.001"	0	0	0
"252704"	"GUSTAV ZIEGLER GMBH"	"12.999.01.003"	0	1	-1
"252704"	"GUSTAV ZIEGLER GMBH"	"12.999.01.162"	4	0	4
"252704"	"GUSTAV ZIEGLER GMBH"	"12.999.01.163"	1	0	1
"253032"	"KLUMPP & MUELLER GMBH & CO. KG"	"12.999.01.001"	1	0	1
"253032"	"KLUMPP & MUELLER GMBH & CO. KG"	"12.999.01.003"	1	0	1
"260216"	"BNT GMBH"	"12.999.01.001"	2	2	0
"260217"	"T. BRANDL GMBH & CO. KG"	"12.999.01.001"	0	0	0
"260217"	"T. BRANDL GMBH & CO. KG"	"12.999.01.003"	0	0	0
"260218"	"Lely Agrartechnik GmbH"	"12.999.01.001"	2	2	0
"260405"	"JOHANN DEMMLER KG"	"12.999.01.001"	5	4	1
"260405"	"JOHANN DEMMLER KG"	"12.999.01.003"	14	4	10
"260502"	"ECKART Maschinenbau GmbH"	"12.999.01.001"	1	1	0
"260604"	"JOSEF FINKL KG"	"12.999.01.001"	2	11	-9
"260613"	"FLIEGL FAHRZEUGBAU GMBH"	"12.999.01.001"	281	76	205
"260613"	"FLIEGL FAHRZEUGBAU GMBH"	"12.999.01.003"	129	44	85
"260613"	"FLIEGL FAHRZEUGBAU GMBH"	"12.999.01.008"	46	17	29
"260613"	"FLIEGL FAHRZEUGBAU GMBH"	"12.999.01.162"	-6	0	-6
"260613"	"FLIEGL FAHRZEUGBAU GMBH"	"12.999.01.163"	-6	0	-6
"260613"	"FLIEGL FAHRZEUGBAU GMBH"	"12.999.01.165"	8	0	8
"260613"	"FLIEGL FAHRZEUGBAU GMBH"	"12.999.01.188"	68	80	-12
"260618"	"FLIEGL Agrartechnik GmbH"	"12.999.01.001"	0	0	0
"260618"	"FLIEGL Agrartechnik GmbH"	"12.999.01.008"	12	0	12
"260618"	"FLIEGL Agrartechnik GmbH"	"12.999.01.162"	14	0	14
"260618"	"FLIEGL Agrartechnik GmbH"	"12.999.01.163"	14	0	14
"260618"	"FLIEGL Agrartechnik GmbH"	"12.999.01.188"	12	0	12
"260702"	"JOSEF GEIDOBLER & SOHN GMBH"	"12.999.01.001"	0	2	-2
"260702"	"JOSEF GEIDOBLER & SOHN GMBH"	"12.999.01.003"	1	1	0
"260704"	"Goldhofer Aktiengesellschaft"	"12.999.01.001"	7	20	-13
"260704"	"Goldhofer Aktiengesellschaft"	"12.999.01.003"	43	91	-48
"260704"	"Goldhofer Aktiengesellschaft"	"12.999.01.008"	2	9	-7
"260704"	"Goldhofer Aktiengesellschaft"	"12.999.01.162"	4	51	-47
"260704"	"Goldhofer Aktiengesellschaft"	"12.999.01.163"	1	11	-10
"260704"	"Goldhofer Aktiengesellschaft"	"12.999.01.188"	0	0	0
"260714"	"GLOGGER FAHRZEUGBAU GMBH"	"12.999.01.001"	0	0	0
"260714"	"GLOGGER FAHRZEUGBAU GMBH"	"12.999.01.003"	0	0	0
"260803"	"HUTTNER"	"12.999.01.001"	0	1	-1
"260803"	"HUTTNER"	"12.999.01.003"	0	2	-2
"260807"	"HERMANN HARBECK"	"12.999.01.001"	1	1	0
"260807"	"HERMANN HARBECK"	"12.999.01.003"	2	2	0
"260811"	"HUMBAUR GMBH"	"12.999.01.001"	17	16	1
"260811"	"HUMBAUR GMBH"	"12.999.01.003"	24	24	0
"260811"	"HUMBAUR GMBH"	"12.999.01.008"	6	2	4
"260811"	"HUMBAUR GMBH"	"12.999.01.162"	16	8	8
"260811"	"HUMBAUR GMBH"	"12.999.01.163"	4	2	2
"260811"	"HUMBAUR GMBH"	"12.999.01.188"	3	3	0
"260813"	"HOFMANN"	"12.999.01.001"	0	0	0
"260813"	"HOFMANN"	"12.999.01.003"	0	0	0
"260813"	"HOFMANN"	"12.999.01.188"	0	0	0
"261113"	"MASCHINENBAU KNOTT GMBH"	"12.999.01.001"	-1	0	-1
"261115"	"KAFFL Fahrzeugbau GmbH"	"12.999.01.001"	0	0	0
"261132"	"KUVVETLI FAHRZEUGBAU e.K."	"12.999.01.001"	0	0	0
"261132"	"KUVVETLI FAHRZEUGBAU e.K."	"12.999.01.003"	0	0	0
"261203"	"LINDNER & FISCHER"	"12.999.01.001"	10	7	3
"261203"	"LINDNER & FISCHER"	"12.999.01.003"	1	1	0
"261203"	"LINDNER & FISCHER"	"12.999.01.188"	7	3	4
"261305"	"ISM INDUSTRIESERVICE"	"12.999.01.001"	0	0	0
"261305"	"ISM INDUSTRIESERVICE"	"12.999.01.003"	0	0	0
"261305"	"ISM INDUSTRIESERVICE"	"12.999.01.188"	0	0	0
"261312"	"MEUSBURGER"	"12.999.01.001"	430	23	407
"261312"	"MEUSBURGER"	"12.999.01.003"	423	20	403
"261312"	"MEUSBURGER"	"12.999.01.008"	35	5	30
"261312"	"MEUSBURGER"	"12.999.01.162"	80	44	36
"261312"	"MEUSBURGER"	"12.999.01.163"	38	12	26
"261312"	"MEUSBURGER"	"12.999.01.188"	36	3	33
"261606"	"Paul Nutzfahrzeuge GmbH"	"12.999.01.001"	2	0	2
"261606"	"Paul Nutzfahrzeuge GmbH"	"12.999.01.003"	11	4	7
"261802"	"MARTIN REISCH GMBH"	"12.999.01.001"	6	6	0
"261802"	"MARTIN REISCH GMBH"	"12.999.01.003"	10	4	6
"261802"	"MARTIN REISCH GMBH"	"12.999.01.162"	8	2	6
"261802"	"MARTIN REISCH GMBH"	"12.999.01.163"	3	1	2
"261802"	"MARTIN REISCH GMBH"	"12.999.01.188"	14	4	10
"261809"	"MARTIN REISCH GMBH"	"12.999.01.001"	14	4	10
"261809"	"MARTIN REISCH GMBH"	"12.999.01.003"	6	0	6
"261809"	"MARTIN REISCH GMBH"	"12.999.01.162"	14	0	14
"261809"	"MARTIN REISCH GMBH"	"12.999.01.163"	3	0	3
"261809"	"MARTIN REISCH GMBH"	"12.999.01.188"	28	27	1
"261815"	"ROPA"	"12.999.01.003"	1	1	0
"261815"	"ROPA"	"12.999.01.008"	2	2	0
"261818"	"NUTZFAHRZEUGE ROHR GMBH"	"12.999.01.001"	20	12	8
"261818"	"NUTZFAHRZEUGE ROHR GMBH"	"12.999.01.003"	8	4	4
"261818"	"NUTZFAHRZEUGE ROHR GMBH"	"12.999.01.188"	30	16	14
"261905"	"ZF SACHS AG"	"12.999.01.001"	29	142	-113
"261905"	"ZF SACHS AG"	"12.999.01.003"	0	5	-5
"262036"	"SCHMID FAHRZEUGBAU GMBH"	"12.999.01.001"	2	4	-2
"262036"	"SCHMID FAHRZEUGBAU GMBH"	"12.999.01.003"	2	4	-2
"262103"	"AUTOTEILE STREB"	"12.999.01.001"	8	14	-6
"262103"	"AUTOTEILE STREB"	"12.999.01.003"	0	0	0
"262217"	"TROST AUTO SERVICE TECHNIK SE"	"12.999.01.001"	1	0	1
"262217"	"TROST AUTO SERVICE TECHNIK SE"	"12.999.01.003"	2	0	2
"262404"	"REINHARD VACHAL"	"12.999.01.001"	0	0	0
"262404"	"REINHARD VACHAL"	"12.999.01.003"	0	0	0
"262506"	"KURT WILLIG GMBH & CO. KG"	"12.999.01.001"	1	0	1
"262506"	"KURT WILLIG GMBH & CO. KG"	"12.999.01.003"	3	0	3
"262510"	"WAGNER-FAHRZEUGBAU GMBH"	"12.999.01.001"	0	0	0
"262703"	"ZUNHAMMER GMBH"	"12.999.01.001"	9	0	9
"262703"	"ZUNHAMMER GMBH"	"12.999.01.003"	4	0	4
"262705"	"Zanner Fahrzeugbau GmbH"	"12.999.01.001"	1	1	0
"262706"	"ZEBU FAHRZEUGBAU GmbH & Co. KG"	"12.999.01.001"	0	0	0
"262706"	"ZEBU FAHRZEUGBAU GmbH & Co. KG"	"12.999.01.003"	0	0	0
"263015"	"BAYWA AG"	"12.999.01.001"	0	1	-1
"270104"	"ANNABURGER NUTZFAHRZEUG GMBH"	"12.999.01.001"	0	2	-2
"270104"	"ANNABURGER NUTZFAHRZEUG GMBH"	"12.999.01.003"	1	4	-3
"270119"	"ACKERMANN FAHRZEUGBAU"	"12.999.01.001"	28	12	16
"270119"	"ACKERMANN FAHRZEUGBAU"	"12.999.01.003"	14	9	5
"270119"	"ACKERMANN FAHRZEUGBAU"	"12.999.01.188"	9	4	5
"270204"	"BEFA  BELZIGER-"	"12.999.01.001"	0	2	-2
"270204"	"BEFA  BELZIGER-"	"12.999.01.003"	0	1	-1
"270204"	"BEFA  BELZIGER-"	"12.999.01.162"	0	2	-2
"270204"	"BEFA  BELZIGER-"	"12.999.01.163"	0	1	-1
"270404"	"Kurt Dinkel"	"12.999.01.001"	18	5	13
"270404"	"Kurt Dinkel"	"12.999.01.003"	3	3	0
"270404"	"Kurt Dinkel"	"12.999.01.188"	1	2	-1
"270620"	"Feldbinder"	"12.999.01.001"	35	26	9
"270620"	"Feldbinder"	"12.999.01.003"	3	5	-2
"270620"	"Feldbinder"	"12.999.01.008"	-2	2	-4
"270620"	"Feldbinder"	"12.999.01.162"	1	0	1
"270620"	"Feldbinder"	"12.999.01.163"	0	0	0
"270620"	"Feldbinder"	"12.999.01.188"	25	43	-18
"270624"	"FAG"	"12.999.01.001"	1	1	0
"270624"	"FAG"	"12.999.01.003"	-1	0	-1
"270624"	"FAG"	"12.999.01.162"	8	8	0
"270624"	"FAG"	"12.999.01.163"	2	2	0
"270624"	"FAG"	"12.999.01.188"	1	0	1
"270804"	"Hüffermann"	"12.999.01.001"	26	39	-13
"270804"	"Hüffermann"	"12.999.01.003"	20	50	-30
"270804"	"Hüffermann"	"12.999.01.008"	0	5	-5
"270804"	"Hüffermann"	"12.999.01.162"	75	30	45
"270804"	"Hüffermann"	"12.999.01.163"	11	10	1
"270804"	"Hüffermann"	"12.999.01.188"	6	17	-11
"270805"	"HERZ NUTZFAHRZEUGTEILE GMBH"	"12.999.01.001"	0	3	-3
"270805"	"HERZ NUTZFAHRZEUGTEILE GMBH"	"12.999.01.003"	0	1	-1
"270810"	"HKM FAHRZEUGBAU GMBH"	"12.999.01.001"	12	17	-5
"270810"	"HKM FAHRZEUGBAU GMBH"	"12.999.01.003"	10	10	0
"270810"	"HKM FAHRZEUGBAU GMBH"	"12.999.01.162"	2	2	0
"270810"	"HKM FAHRZEUGBAU GMBH"	"12.999.01.163"	1	1	0
"270810"	"HKM FAHRZEUGBAU GMBH"	"12.999.01.188"	2	2	0
"271102"	"FRANK & SOHN"	"12.999.01.001"	0	4	-4
"271114"	"Kirow Ardelt GmbH"	"12.999.01.003"	8	4	4
"271118"	"PLATAL MOBILSYSTEME GMBH"	"12.999.01.001"	0	0	0
"271118"	"PLATAL MOBILSYSTEME GMBH"	"12.999.01.003"	0	0	0
"271307"	"FMS Fahrzeugbau GmbH"	"12.999.01.001"	3	10	-7
"271307"	"FMS Fahrzeugbau GmbH"	"12.999.01.003"	0	3	-3
"271307"	"FMS Fahrzeugbau GmbH"	"12.999.01.162"	2	10	-8
"271307"	"FMS Fahrzeugbau GmbH"	"12.999.01.163"	1	3	-2
"271307"	"FMS Fahrzeugbau GmbH"	"12.999.01.188"	0	1	-1
"271311"	"MAFA"	"12.999.01.001"	22	9	13
"271311"	"MAFA"	"12.999.01.162"	-4	0	-4
"271311"	"MAFA"	"12.999.01.188"	25	7	18
"271318"	"MKF"	"12.999.01.003"	0	0	0
"271505"	"ORTEN GmbH & Co. KG"	"12.999.01.001"	1	0	1
"271505"	"ORTEN GmbH & Co. KG"	"12.999.01.003"	-1	0	-1
"271910"	"SAXAS"	"12.999.01.001"	1	2	-1
"271910"	"SAXAS"	"12.999.01.008"	0	0	0
"272017"	"Schmitz Cargobull"	"12.999.01.001"	2	5	-3
"272017"	"Schmitz Cargobull"	"12.999.01.003"	0	1	-1
"272017"	"Schmitz Cargobull"	"12.999.01.008"	1	1	0
"272017"	"Schmitz Cargobull"	"12.999.01.188"	4	7	-3
"272502"	"Schlosser Europart"	"12.999.01.001"	2	0	2
"272502"	"Schlosser Europart"	"12.999.01.003"	2	0	2
"272502"	"Schlosser Europart"	"12.999.01.008"	1	0	1
"272505"	"WILLIG FAHRZEUGBAU GMBH"	"12.999.01.001"	2	3	-1
"272505"	"WILLIG FAHRZEUGBAU GMBH"	"12.999.01.003"	0	1	-1
"272505"	"WILLIG FAHRZEUGBAU GMBH"	"12.999.01.008"	0	0	0
"272505"	"WILLIG FAHRZEUGBAU GMBH"	"12.999.01.188"	2	2	0
"272506"	"WESSEL-FAHRZEUGTEILE GMBH"	"12.999.01.001"	0	6	-6
"272506"	"WESSEL-FAHRZEUGTEILE GMBH"	"12.999.01.003"	0	3	-3
"280237"	"M. BUSCH GMBH & CO. KG"	"12.999.01.001"	0	20	-20
"280237"	"M. BUSCH GMBH & CO. KG"	"12.999.01.003"	0	10	-10
"280237"	"M. BUSCH GMBH & CO. KG"	"12.999.01.008"	0	40	-40
"310052"	"BOTHE-SCHNITZIUS GMBH & CO."	"12.999.01.003"	0	2	-2
"320006"	"OFFERGELD GMBH & CO."	"12.999.01.001"	1	0	1
"320037"	"Frye Transport-Logistik GMBH"	"12.999.01.003"	-216	410	-626
"320080"	"GEORG KRAEMER FAHRZEUGBAU"	"12.999.01.001"	0	0	0
"320080"	"GEORG KRAEMER FAHRZEUGBAU"	"12.999.01.003"	1	3	-2
"320102"	"NCG NUTZFAHRZEUG-CENTER GMBH"	"12.999.01.001"	1	0	1
"320132"	"KAMAX-WERKE"	"12.999.01.003"	-74	67	-141
"320132"	"KAMAX-WERKE"	"12.999.01.008"	513	660	-147
"320147"	"JOHANNES REINERS"	"12.999.01.001"	1	0	1
"320150"	"Nagel-Group"	"12.999.01.001"	1	0	1
"320150"	"Nagel-Group"	"12.999.01.003"	2	0	2
"360083"	"FEDLMEIER GMBH"	"12.999.01.001"	1	1	0
"360083"	"FEDLMEIER GMBH"	"12.999.01.003"	1	1	0
"360132"	"P. SCHWANDNER"	"12.999.01.001"	1	0	1
"370002"	"SCANRO GMBH"	"12.999.01.001"	0	3	-3
"370028"	"Fahrzeugbau und Entwicklungswerk"	"12.999.01.001"	1	1	0
"370028"	"Fahrzeugbau und Entwicklungswerk"	"12.999.01.003"	1	1	0
"370046"	"Elflein Spedition & Transport GmbH"	"12.999.01.001"	1	0	1
"370046"	"Elflein Spedition & Transport GmbH"	"12.999.01.003"	1	0	1
"370175"	"Manfred Manig"	"12.999.01.001"	1	0	1
"370186"	"GRESS + ZAPP GMBH"	"12.999.01.003"	1	1	0
"370187"	"Anton Dülk Nutzfahrzeuge"	"12.999.01.001"	1	1	0
"390502"	"WINCANTON TRANS EUROPEAN (D) GmbH"	"12.999.01.003"	-4	0	-4
"390503"	"WIELAND-WERKE AG"	"12.999.01.001"	-4	0	-4
"390503"	"WIELAND-WERKE AG"	"12.999.01.003"	-60	0	-60
"390510"	"TMD FRICTION GMBH"	"12.999.01.001"	383	429	-46
"390510"	"TMD FRICTION GMBH"	"12.999.01.003"	206	290	-84
"390510"	"TMD FRICTION GMBH"	"12.999.01.008"	795	772	23
"390511"	"SONA BLW"	"12.999.01.001"	-3	0	-3
"390511"	"SONA BLW"	"12.999.01.003"	-1	0	-1
"390513"	"THIEL & HOCHE GMBH & CO. KG"	"12.999.01.001"	19	60	-41
"390513"	"THIEL & HOCHE GMBH & CO. KG"	"12.999.01.003"	17	4	13
"390513"	"THIEL & HOCHE GMBH & CO. KG"	"12.999.01.008"	53	0	53
"390514"	"THH DREHTEILE GMBH"	"12.999.01.001"	3	0	3
"390514"	"THH DREHTEILE GMBH"	"12.999.01.003"	-4	0	-4
"390516"	"ERICH SYDOW GMBH & CO. KG"	"12.999.01.003"	-1	0	-1
"390519"	"SKF GmbH"	"12.999.01.003"	27	27	0
"390525"	"SCHIEFFER GMBH & CO. KG"	"12.999.01.001"	63	0	63
"390525"	"SCHIEFFER GMBH & CO. KG"	"12.999.01.003"	-31	20	-51
"390525"	"SCHIEFFER GMBH & CO. KG"	"12.999.01.008"	54	8	46
"390526"	"SCHENKER"	"12.999.01.001"	17	60	-43
"390528"	"ADOLF PUEHL GMBH & CO. KG"	"12.999.01.001"	-3	0	-3
"390528"	"ADOLF PUEHL GMBH & CO. KG"	"12.999.01.003"	-114	0	-114
"390530"	"PEINER UMFORMTECHNIK GMBH"	"12.999.01.003"	-267	0	-267
"390530"	"PEINER UMFORMTECHNIK GMBH"	"12.999.01.008"	651	0	651
"390531"	"ALEXANDER PAAL GMBH"	"12.999.01.003"	-121	0	-121
"390531"	"ALEXANDER PAAL GMBH"	"12.999.01.008"	82	0	82
"390533"	"NEUHAUS"	"12.999.01.001"	86	3	83
"390533"	"NEUHAUS"	"12.999.01.003"	-120	24	-144
"390533"	"NEUHAUS"	"12.999.01.008"	257	225	32
"390534"	"TNT Innight GmbH & Co.KG"	"12.999.01.001"	81	51	30
"390534"	"TNT Innight GmbH & Co.KG"	"12.999.01.003"	4	0	4
"390537"	"MOHR + FRIEDRICH GMBH"	"12.999.01.001"	1	0	1
"390537"	"MOHR + FRIEDRICH GMBH"	"12.999.01.003"	8	270	-262
"390537"	"MOHR + FRIEDRICH GMBH"	"12.999.01.008"	267	196	71
"390538"	"GUSTAV MEYER GMBH & CO."	"12.999.01.003"	4	0	4
"390538"	"GUSTAV MEYER GMBH & CO."	"12.999.01.008"	28	0	28
"390539"	"MAYER-JUMBO"	"12.999.01.001"	2	0	2
"390542"	"LST - GMBH"	"12.999.01.001"	-8	0	-8
"390542"	"LST - GMBH"	"12.999.01.003"	1	0	1
"390543"	"LIPPISCHE EISENINDUSTRIE GMBH"	"12.999.01.003"	-561	16	-577
"390543"	"LIPPISCHE EISENINDUSTRIE GMBH"	"12.999.01.008"	201	160	41
"390546"	"GESENK- UND FREIFORMSCHMIEDE"	"12.999.01.001"	-33	0	-33
"390555"	"KAUSEMANN GMBH"	"12.999.01.001"	6	0	6
"390556"	"JOHNSON DREHTECHNIK GMBH"	"12.999.01.003"	29	10	19
"390556"	"JOHNSON DREHTECHNIK GMBH"	"12.999.01.008"	46	30	16
"390557"	"WALTER HUNDHAUSEN GMBH"	"12.999.01.001"	-50	0	-50
"390557"	"WALTER HUNDHAUSEN GMBH"	"12.999.01.003"	-1	0	-1
"390560"	"HEINRICHS GMBH"	"12.999.01.001"	42	1	41
"390560"	"HEINRICHS GMBH"	"12.999.01.003"	1	0	1
"390560"	"HEINRICHS GMBH"	"12.999.01.008"	12	0	12
"390563"	"GUEDE GMBH"	"12.999.01.003"	-7	0	-7
"390563"	"GUEDE GMBH"	"12.999.01.008"	-26	2	-28
"390564"	"Heinrich Glane GmbH"	"12.999.01.001"	1	46	-45
"390564"	"Heinrich Glane GmbH"	"12.999.01.003"	-799	140	-939
"390567"	"FUCHS SCHRAUBENWERK"	"12.999.01.003"	-42	0	-42
"390567"	"FUCHS SCHRAUBENWERK"	"12.999.01.008"	77	0	77
"390568"	"FORMTEIL- UND SCHRAUBENWERK"	"12.999.01.003"	136	0	136
"390569"	"AUGUST FRIEDBERG GMBH"	"12.999.01.003"	-260	2	-262
"390569"	"AUGUST FRIEDBERG GMBH"	"12.999.01.008"	262	0	262
"390570"	"FREUDENBERG SIMRIT KG"	"12.999.01.001"	-10	0	-10
"390570"	"FREUDENBERG SIMRIT KG"	"12.999.01.003"	-141	0	-141
"390571"	"ANDREAS FRANKE"	"12.999.01.003"	1	0	1
"390572"	"Wälzlager GmbH"	"12.999.01.001"	1	0	1
"390572"	"Wälzlager GmbH"	"12.999.01.003"	81	330	-249
"390572"	"Wälzlager GmbH"	"12.999.01.008"	1	1002	-1001
"390574"	"SAF-Holland GmbH"	"12.999.01.001"	20	0	20
"390574"	"SAF-Holland GmbH"	"12.999.01.003"	-11	0	-11
"390574"	"SAF-Holland GmbH"	"12.999.01.008"	90	0	90
"390575"	"FELDMANN-MAB"	"12.999.01.003"	-19	0	-19
"390575"	"FELDMANN-MAB"	"12.999.01.008"	7	0	7
"390576"	"CFS FALKENROTH UMFORMTECHNIK"	"12.999.01.001"	14	0	14
"390577"	"ESAB GMBH"	"12.999.01.003"	-223	0	-223
"390580"	"RUDOLF ECKEL"	"12.999.01.001"	3	0	3
"390580"	"RUDOLF ECKEL"	"12.999.01.003"	9	4	5
"390581"	"JOSEPH DRESSELHAUS"	"12.999.01.003"	-237	20	-257
"390581"	"JOSEPH DRESSELHAUS"	"12.999.01.008"	205	200	5
"390587"	"Sped. Dachser GmbH & Co. KG"	"12.999.01.003"	-1	0	-1
"390604"	"MORAVSKE KOVARNY A.S."	"12.999.01.011"	-22	0	-22
"402773"	"NICOLAS"	"12.999.01.162"	0	0	0
"402773"	"NICOLAS"	"12.999.01.163"	0	0	0
"404089"	"Rejna"	"12.999.01.001"	1	0	1
"404404"	"TPV d.d."	"12.999.01.001"	71	0	71
"406692"	"SLR-GUSSWERK II"	"12.999.01.001"	-9	0	-9
"408204"	"LECITRAILER S.A."	"12.999.01.001"	0	0	0
"408237"	"FUNDICIONES DE VERA S.A."	"12.999.01.001"	2	12	-10
"408237"	"FUNDICIONES DE VERA S.A."	"12.999.01.003"	212	433	-221
"409002"	"F. X. MEILLER SLANY S.R.O."	"12.999.01.001"	0	33	-33
"409002"	"F. X. MEILLER SLANY S.R.O."	"12.999.01.003"	5	16	-11
"409002"	"F. X. MEILLER SLANY S.R.O."	"12.999.01.008"	-5	2	-7
"409002"	"F. X. MEILLER SLANY S.R.O."	"12.999.01.188"	16	43	-27
"409004"	"BRANO A.S."	"12.999.01.001"	96	260	-164
"409004"	"BRANO A.S."	"12.999.01.003"	4	0	4
"416670"	"FAHRZEUGBEDARF"	"12.999.01.001"	150	185	-35
"416670"	"FAHRZEUGBEDARF"	"12.999.01.003"	648	626	22
"416670"	"FAHRZEUGBEDARF"	"12.999.01.008"	17	33	-16
"416670"	"FAHRZEUGBEDARF"	"12.999.01.162"	107	48	59
"416670"	"FAHRZEUGBEDARF"	"12.999.01.163"	20	10	10
"416670"	"FAHRZEUGBEDARF"	"12.999.01.188"	0	2	-2
"416674"	"Hendrickson Austria GmbH"	"12.999.01.001"	207	52	155
"416674"	"Hendrickson Austria GmbH"	"12.999.01.003"	2	900	-898
"428413"	"MOM Faktor"	"12.999.01.003"	-9	29	-38
"428413"	"MOM Faktor"	"12.999.01.008"	-34	110	-144
"470055"	"Sievering Nutzfahrzeuge GmbH"	"12.999.01.003"	0	2	-2
"490102"	"KUZNIA GLINIK SP.Z.O.O."	"12.999.01.001"	-15	0	-15
"490106"	"FORGING PRODUCTS S.A."	"12.999.01.001"	-88	3	-91
"490106"	"FORGING PRODUCTS S.A."	"12.999.01.003"	-86	35	-121
"490106"	"FORGING PRODUCTS S.A."	"12.999.01.008"	23	0	23
"490106"	"FORGING PRODUCTS S.A."	"12.999.01.011"	-26	0	-26
"490108"	"KAMAX S.R.O. TURNOV"	"12.999.01.003"	-35	0	-35
"490112"	"UNIOR DD"	"12.999.01.003"	74	7	67
"490112"	"UNIOR DD"	"12.999.01.008"	85	60	25
"500005"	"DUMMY-Sonderbestandsführer"	"12.999.01.001"	470	4	466
"500005"	"DUMMY-Sonderbestandsführer"	"12.999.01.003"	1	4	-3
"500005"	"DUMMY-Sonderbestandsführer"	"12.999.01.008"	82	2	80
"500005"	"DUMMY-Sonderbestandsführer"	"12.999.01.011"	-2	0	-2
"500005"	"DUMMY-Sonderbestandsführer"	"12.999.01.188"	71	0	71
"500035"	"EUROPART Materials GmbH"	"12.999.01.001"	42	51	-9
"500035"	"EUROPART Materials GmbH"	"12.999.01.003"	46	51	-5
"500035"	"EUROPART Materials GmbH"	"12.999.01.008"	1	0	1
"500118"	"Cargobull Parts & Services GmbH"	"12.999.01.001"	25	46	-21
"500118"	"Cargobull Parts & Services GmbH"	"12.999.01.003"	11	7	4
"500167"	"MN Kaltformteile"	"12.999.01.003"	-11	0	-11
"500182"	"Frohnauer GmbH"	"12.999.01.001"	1	0	1
"500219"	"Georg Fischer GmbH"	"12.999.01.001"	72	422	-350
"500219"	"Georg Fischer GmbH"	"12.999.01.003"	36	0	36
"500219"	"Georg Fischer GmbH"	"12.999.01.008"	79	0	79
"500245"	"NTV Nutzfahrzeuge"	"12.999.01.001"	2	0	2
"500259"	"Nüsslein"	"12.999.01.001"	1	1	0
"500276"	"TMD Friction Services GmbH"	"12.999.01.003"	0	2	-2
"500291"	"SVG EUROPART Südbaden GmbH"	"12.999.01.003"	2	2	0
"500310"	"Spermann Fahrzeugbau GmbH"	"12.999.01.001"	2	0	2
"500310"	"Spermann Fahrzeugbau GmbH"	"12.999.01.003"	2	0	2
"500331"	"SW Umformtechnik"	"12.999.01.001"	30	32	-2
"500331"	"SW Umformtechnik"	"12.999.01.003"	173	5	168
"500466"	"Hendricks Reparatur & Service"	"12.999.01.003"	0	1	-1
"500621"	"PROFI PARTS"	"12.999.01.001"	2	0	2
"500640"	"Torwesten Spedition GmbH & Co. KG"	"12.999.01.003"	0	1	-1
"500646"	"Schneider Fahrzeugteile"	"12.999.01.001"	1	1	0
"500706"	"HGE Fahrzeugbau GmbH & Co. KG"	"12.999.01.001"	0	1	-1
"500706"	"HGE Fahrzeugbau GmbH & Co. KG"	"12.999.01.188"	0	1	-1
"500757"	"TROST AUTO SERVICE TECHNIK SE"	"12.999.01.001"	1	0	1
"500800"	"Paul Scholz KG"	"12.999.01.003"	0	1	-1
"500820"	"Hofmeister & Meincke GmbH & Co. KG"	"12.999.01.001"	1	0	1
"501044"	"Friedrich Kraft GmbH"	"12.999.01.001"	0	4	-4
"501044"	"Friedrich Kraft GmbH"	"12.999.01.003"	2	4	-2
"501047"	"Friedrich Kraft GmbH"	"12.999.01.003"	0	1	-1
"501146"	"Schwarzmüller"	"12.999.01.188"	191	233	-42
"501210"	"WüTSCHNER"	"12.999.01.001"	0	18	-18
"501221"	"Polyma Energiesysteme GmbH"	"12.999.01.001"	2	0	2
"501233"	"OPTIMAS OE Solutions GmbH"	"12.999.01.003"	-83	0	-83
"501233"	"OPTIMAS OE Solutions GmbH"	"12.999.01.008"	5	0	5
"501243"	"Altha Industrieprodukte"	"12.999.01.003"	15	4	11
"501243"	"Altha Industrieprodukte"	"12.999.01.008"	28	40	-12
"501305"	"Kuznia Jawor SA"	"12.999.01.001"	66	60	6
"501398"	"BIRNER GMBH"	"12.999.01.001"	0	0	0
"501401"	"Bäumle Spedition GmbH"	"12.999.01.001"	1	0	1
"501401"	"Bäumle Spedition GmbH"	"12.999.01.003"	2	0	2
"501508"	"A-W.Heil & Sohn GmbH & Co."	"12.999.01.001"	28	38	-10
"501508"	"A-W.Heil & Sohn GmbH & Co."	"12.999.01.003"	9	5	4
"501620"	"Fietz Thermoplast"	"12.999.01.003"	-24	0	-24
"501681"	"TROST AUTO SERVICE TECHNIK SE"	"12.999.01.001"	1	0	1
"501804"	"Spedition Ottensmann GmbH"	"12.999.01.003"	0	1	-1
"501871"	"Schmitt KFZ GmbH"	"12.999.01.003"	0	2	-2
"501949"	"Heinrich Hamm Speditionsges."	"12.999.01.003"	0	1	-1
"502119"	"Claas Service and Parts GmbH"	"12.999.01.008"	26	0	26
"502219"	"Maschinenfabrik Bernard Krone GmbH"	"12.999.01.001"	0	0	0
"502219"	"Maschinenfabrik Bernard Krone GmbH"	"12.999.01.003"	0	0	0
"502560"	"Haerterei Hauck"	"12.999.01.001"	-7	0	-7
"502560"	"Haerterei Hauck"	"12.999.01.003"	-24	0	-24
"502560"	"Haerterei Hauck"	"12.999.01.008"	36	0	36
"502680"	"Finkl-Fahrzeugbau GmbH"	"12.999.01.001"	2	6	-4
"502680"	"Finkl-Fahrzeugbau GmbH"	"12.999.01.003"	0	4	-4
"502680"	"Finkl-Fahrzeugbau GmbH"	"12.999.01.162"	4	4	0
"502680"	"Finkl-Fahrzeugbau GmbH"	"12.999.01.163"	1	1	0
"502809"	"Franz Mersch GmbH & Co. KG"	"12.999.01.001"	1	2	-1
"503038"	"Weißgerber/Seidner GmbH & Co"	"12.999.01.001"	39	6	33
"503038"	"Weißgerber/Seidner GmbH & Co"	"12.999.01.003"	224	77	147
"503131"	"Contitech Luftfedersysteme GmbH"	"12.999.01.001"	-1	1	-2
"503173"	"Bohnet GmbH"	"12.999.01.001"	5	0	5
"503208"	"Rainer Volk"	"12.999.01.001"	2	0	2
"503240"	"Wessels Vrees"	"12.999.01.001"	10	0	10
"503269"	"Sinco Tec"	"12.999.01.001"	4	0	4
"503356"	"Arnold Umformtechnik"	"12.999.01.003"	7	0	7
"503490"	"B. Stade, Inh. M. Stade"	"12.999.01.003"	1	0	1
"503494"	"VCT Vogel GmbH"	"12.999.01.001"	0	0	0
"503494"	"VCT Vogel GmbH"	"12.999.01.003"	0	0	0
"503494"	"VCT Vogel GmbH"	"12.999.01.188"	0	0	0
"503550"	"ForFarmers GmbH"	"12.999.01.003"	0	1	-1
"503634"	"Wessels + Müller AG"	"12.999.01.001"	1	0	1
"503638"	"Fahrzeugbau GmbH Ladeburg"	"12.999.01.001"	1	3	-2
"503853"	"Waldemar Fromm"	"12.999.01.001"	1	1	0
"503935"	"BPW TRAPACO, S.L."	"12.999.01.001"	0	1	-1
"503996"	"System Trailers GmbH"	"12.999.01.001"	63	42	21
"503996"	"System Trailers GmbH"	"12.999.01.003"	11	13	-2
"503996"	"System Trailers GmbH"	"12.999.01.008"	5	5	0
"503996"	"System Trailers GmbH"	"12.999.01.162"	14	0	14
"503996"	"System Trailers GmbH"	"12.999.01.188"	78	59	19
"504022"	"Vaal-Transporte GmbH"	"12.999.01.001"	1	1	0
"504307"	"Zemmler"	"12.999.01.001"	1	4	-3
"504307"	"Zemmler"	"12.999.01.003"	1	4	-3
"504337"	"RUFA Fahrzeugbau GmbH"	"12.999.01.001"	1	5	-4
"504337"	"RUFA Fahrzeugbau GmbH"	"12.999.01.003"	1	5	-4
"504337"	"RUFA Fahrzeugbau GmbH"	"12.999.01.188"	3	0	3
"504462"	"TMD Friction  GmbH Coswig"	"12.999.01.003"	3	0	3
"504483"	"Streicher Landmaschinen GmbH"	"12.999.01.001"	1	0	1
"504689"	"HS-Schoch GmbH"	"12.999.01.001"	-96	0	-96
"504689"	"HS-Schoch GmbH"	"12.999.01.003"	-332	0	-332
"504728"	"Grimme Landmaschinentechnik"	"12.999.01.001"	12	1	11
"504728"	"Grimme Landmaschinentechnik"	"12.999.01.003"	3	2	1
"504728"	"Grimme Landmaschinentechnik"	"12.999.01.008"	6	2	4
"504864"	"Lenicker GmbH"	"12.999.01.001"	3	1	2
"504880"	"Lisi Automotive-Knipping"	"12.999.01.003"	-7	8	-15
"504902"	"Peter Ortmann"	"12.999.01.001"	0	0	0
"505279"	"Reiner Reichert"	"12.999.01.001"	0	0	0
"505279"	"Reiner Reichert"	"12.999.01.003"	1	1	0
"505279"	"Reiner Reichert"	"12.999.01.188"	0	0	0
"505303"	"Kurt Willig GmbH & Co. KG"	"12.999.01.001"	-2	10	-12
"505303"	"Kurt Willig GmbH & Co. KG"	"12.999.01.003"	-2	5	-7
"505303"	"Kurt Willig GmbH & Co. KG"	"12.999.01.188"	10	12	-2
"505429"	"BPW Benelux sprl."	"12.999.01.001"	0	1	-1
"505485"	"ELHA Maschinenbau"	"12.999.01.001"	-7	0	-7
"505485"	"ELHA Maschinenbau"	"12.999.01.003"	2	0	2
"505515"	"RMW Rotenburger"	"12.999.01.003"	34	0	34
"505519"	"Brueggen Komponenten GmbH"	"12.999.01.001"	554	223	331
"505519"	"Brueggen Komponenten GmbH"	"12.999.01.003"	25	9	16
"505519"	"Brueggen Komponenten GmbH"	"12.999.01.008"	35	19	16
"505519"	"Brueggen Komponenten GmbH"	"12.999.01.162"	16	0	16
"505519"	"Brueggen Komponenten GmbH"	"12.999.01.163"	3	0	3
"505519"	"Brueggen Komponenten GmbH"	"12.999.01.188"	205	489	-284
"505548"	"Colombo Special Fasteners"	"12.999.01.003"	37	26	11
"505548"	"Colombo Special Fasteners"	"12.999.01.008"	99	60	39
"505595"	"Koch GmbH & Co. KG"	"12.999.01.001"	2	2	0
"505663"	"Schaeffler  KG"	"12.999.01.003"	-1	0	-1
"505664"	"Springfix"	"12.999.01.003"	9	0	9
"505666"	"Pöppelmann GmbH & Co."	"12.999.01.003"	-18	0	-18
"505668"	"Willi Hahn GmbH"	"12.999.01.003"	-12	0	-12
"505695"	"Knoll GmbH"	"12.999.01.001"	-2	0	-2
"505737"	"Vollmer + Boch"	"12.999.01.001"	31	0	31
"505737"	"Vollmer + Boch"	"12.999.01.003"	46	0	46
"505738"	"Mildner Fahrzeugbau GmbH"	"12.999.01.001"	47	18	29
"505738"	"Mildner Fahrzeugbau GmbH"	"12.999.01.003"	22	22	0
"505738"	"Mildner Fahrzeugbau GmbH"	"12.999.01.008"	9	3	6
"505738"	"Mildner Fahrzeugbau GmbH"	"12.999.01.188"	3	1	2
"505825"	"Geroh GmbH & Co. KG"	"12.999.01.003"	0	0	0
"505856"	"CT Kran-Cervice GmbH"	"12.999.01.001"	2	0	2
"505910"	"Wilhelm Schauerte"	"12.999.01.001"	-20	0	-20
"505910"	"Wilhelm Schauerte"	"12.999.01.003"	2	0	2
"505910"	"Wilhelm Schauerte"	"12.999.01.008"	-1	0	-1
"506215"	"Walter Fink"	"12.999.01.001"	1	0	1
"506371"	"LS Kunststofftechnologie GmbH"	"12.999.01.003"	27	143	-116
"506466"	"BayWa AG Obertraubling"	"12.999.01.001"	0	0	0
"506695"	"Rauch Landmaschinenfabrik Gmbh"	"12.999.01.008"	0	0	0
"506832"	"Johann Vitz GmbH & Co. KG"	"12.999.01.003"	4	16	-12
"506991"	"Eurotank GmbH"	"12.999.01.001"	2	2	0
"506991"	"Eurotank GmbH"	"12.999.01.188"	0	0	0
"507049"	"Tenneco Automotive"	"12.999.01.001"	0	50	-50
"507063"	"Liebherr-Mischtechnik GmbH"	"12.999.01.003"	1	1	0
"507539"	"Benninghoven"	"12.999.01.003"	2	0	2
"507566"	"Jürgen Seifert"	"12.999.01.001"	1	1	0
"507576"	"Tiemann Truck & Bus GmbH"	"12.999.01.001"	1	1	0
"507576"	"Tiemann Truck & Bus GmbH"	"12.999.01.003"	1	1	0
"507597"	"Kögel Trailer GmbH & Co. KG"	"12.999.01.001"	55	39	16
"507597"	"Kögel Trailer GmbH & Co. KG"	"12.999.01.003"	1	1	0
"507597"	"Kögel Trailer GmbH & Co. KG"	"12.999.01.008"	1	5	-4
"507597"	"Kögel Trailer GmbH & Co. KG"	"12.999.01.162"	6	26	-20
"507597"	"Kögel Trailer GmbH & Co. KG"	"12.999.01.163"	1	7	-6
"507597"	"Kögel Trailer GmbH & Co. KG"	"12.999.01.188"	42	83	-41
"507646"	"Mager GmbH"	"12.999.01.001"	-17	0	-17
"507646"	"Mager GmbH"	"12.999.01.003"	4	1	3
"507646"	"Mager GmbH"	"12.999.01.008"	31	12	19
"507679"	"Amazone Technologie Leeden"	"12.999.01.008"	1	0	1
"507683"	"MTE"	"12.999.01.001"	2	2	0
"507737"	"Möller Fahrzeugbau"	"12.999.01.001"	1	0	1
"507737"	"Möller Fahrzeugbau"	"12.999.01.008"	1	0	1
"507738"	"Eckstein GmbH & Co.KG"	"12.999.01.001"	8	0	8
"507738"	"Eckstein GmbH & Co.KG"	"12.999.01.003"	13	0	13
"507778"	"Breuer & Wasel GmbH"	"12.999.01.001"	0	0	0
"507778"	"Breuer & Wasel GmbH"	"12.999.01.003"	0	1	-1
"507864"	"Dietsch Speditionsges.mbH"	"12.999.01.003"	0	0	0
"508072"	"Fahrzeugbau Ladeburg"	"12.999.01.001"	1	2	-1
"508122"	"Reinhard Darming"	"12.999.01.003"	4	3	1
"508162"	"Zuern Harvesting GmbH & Co. KG"	"12.999.01.001"	5	0	5
"508219"	"TROST AUTO SERVICE TECHNIK SE"	"12.999.01.001"	54	28	26
"508219"	"TROST AUTO SERVICE TECHNIK SE"	"12.999.01.003"	9	5	4
"508293"	"Pankoke & Roll GmbH & Co.KG"	"12.999.01.001"	0	1	-1
"508471"	"Grotlüschen Fahrzeugbau oHG"	"12.999.01.003"	0	1	-1
"508535"	"Blomenröhr Fahrzeugbau"	"12.999.01.001"	0	0	0
"508535"	"Blomenröhr Fahrzeugbau"	"12.999.01.003"	0	0	0
"508628"	"Beilharz Nutzfahrzeuge Duisburg Gmb"	"12.999.01.001"	13	0	13
"508628"	"Beilharz Nutzfahrzeuge Duisburg Gmb"	"12.999.01.003"	7	3	4
"508794"	"Agravis Technik Saltenbrock GmbH"	"12.999.01.001"	1	0	1
"508946"	"He - Wa Aufbau"	"12.999.01.001"	0	1	-1
"508946"	"He - Wa Aufbau"	"12.999.01.003"	0	1	-1
"508946"	"He - Wa Aufbau"	"12.999.01.008"	0	0	0
"508979"	"Lemmer GmbH & Co. KG"	"12.999.01.001"	-92	0	-92
"508979"	"Lemmer GmbH & Co. KG"	"12.999.01.003"	89	0	89
"508979"	"Lemmer GmbH & Co. KG"	"12.999.01.008"	40	0	40
"509026"	"Land & Technik-Service GmbH"	"12.999.01.003"	1	1	0
"509379"	"Vibracoustic CV Air Springs"	"12.999.01.001"	178	1830	-1652
"509379"	"Vibracoustic CV Air Springs"	"12.999.01.003"	20	2	18
"509379"	"Vibracoustic CV Air Springs"	"12.999.01.008"	30	8	22
"509460"	"Frauenthal Automotive"	"12.999.01.001"	75	0	75
"509460"	"Frauenthal Automotive"	"12.999.01.003"	98	75	23
"509460"	"Frauenthal Automotive"	"12.999.01.008"	259	300	-41
"509890"	"HZ - Elbe Autoersatzt.. GmbH & CO."	"12.999.01.001"	1	0	1
"509953"	"PM Hermann Perk"	"12.999.01.001"	2	0	2
"509953"	"PM Hermann Perk"	"12.999.01.008"	1	0	1
"510569"	"FLEXIMOL"	"12.999.01.001"	83	0	83
"510569"	"FLEXIMOL"	"12.999.01.003"	-3	0	-3
"510898"	"Steinbruch Schorr"	"12.999.01.003"	2	2	0
"510946"	"Sebastian Obermaier"	"12.999.01.001"	1	0	1
"510946"	"Sebastian Obermaier"	"12.999.01.003"	1	0	1
"511327"	"Rübsam & Co."	"12.999.01.001"	3	0	3
"511327"	"Rübsam & Co."	"12.999.01.008"	11	0	11
"511368"	"M Reithelshöfer GMBH"	"12.999.01.001"	0	0	0
"511539"	"Wütschner"	"12.999.01.001"	1	1	0
"511577"	"Friedrich Kraft GmbH"	"12.999.01.001"	0	1	-1
"511885"	"CIMC Silvergreen Germany GmbH"	"12.999.01.001"	1	0	1
"511885"	"CIMC Silvergreen Germany GmbH"	"12.999.01.188"	23	0	23
"511928"	"Kögel, s. r. o."	"12.999.01.001"	-12	4	-16
"512068"	"SIGA Fahrzeugtechnik"	"12.999.01.188"	1	0	1
"512338"	"H & W"	"12.999.01.001"	2	9	-7
"512338"	"H & W"	"12.999.01.003"	1	7	-6
"512338"	"H & W"	"12.999.01.008"	0	5	-5
"512338"	"H & W"	"12.999.01.162"	4	2	2
"512338"	"H & W"	"12.999.01.163"	1	1	0
"512338"	"H & W"	"12.999.01.188"	5	2	3
"512540"	"Emil Giebel"	"12.999.01.001"	0	1	-1
"512578"	"TBZ GmbH"	"12.999.01.001"	6	0	6
"512578"	"TBZ GmbH"	"12.999.01.003"	6	0	6
"512611"	"K+G tec GmbH"	"12.999.01.001"	0	0	0
"512611"	"K+G tec GmbH"	"12.999.01.188"	3	0	3
"512620"	"Fellechner Fahrzeugbau GmbH"	"12.999.01.001"	3	8	-5
"512620"	"Fellechner Fahrzeugbau GmbH"	"12.999.01.003"	0	6	-6
"512620"	"Fellechner Fahrzeugbau GmbH"	"12.999.01.008"	0	2	-2
"512620"	"Fellechner Fahrzeugbau GmbH"	"12.999.01.162"	0	2	-2
"512620"	"Fellechner Fahrzeugbau GmbH"	"12.999.01.163"	0	1	-1
"512620"	"Fellechner Fahrzeugbau GmbH"	"12.999.01.188"	3	3	0
"512808"	"Fischl Fahrzeugbau GmbH"	"12.999.01.001"	1	1	0
"512808"	"Fischl Fahrzeugbau GmbH"	"12.999.01.003"	2	2	0
"512847"	"GEREP"	"12.999.01.001"	-10	0	-10
"512886"	"Exporient Middle East for"	"12.999.01.003"	0	2	-2
"512941"	"E. Heidrich"	"12.999.01.001"	0	0	0
"513076"	"Spedition Calenberg"	"12.999.01.001"	0	0	0
"513211"	"Schuler Fahrzeugbau GmbH"	"12.999.01.001"	7	1	6
"513721"	"Kumm Technik GmbH"	"12.999.01.001"	1	0	1
"513721"	"Kumm Technik GmbH"	"12.999.01.003"	2	0	2
"513775"	"Kreitz"	"12.999.01.001"	1	0	1
"514085"	"NTV Nutzfahrzeugteile Oesterhaus KG"	"12.999.01.001"	0	0	0
"514300"	"Otto Fuchs KG"	"12.999.01.003"	3	0	3
"514300"	"Otto Fuchs KG"	"12.999.01.008"	80	0	80
"514535"	"CTJ Janssen GmbH"	"12.999.01.001"	1	0	1
"514681"	"Universal Transport Schmitz"	"12.999.01.001"	0	0	0
"514868"	"BMD Baumechanisierung"	"12.999.01.001"	1	0	1
"518187"	"Modschiedler Logistik GmbH"	"12.999.01.001"	0	0	0
"519843"	"Bermel  Spedition, Logistik"	"12.999.01.001"	2	2	0
"520059"	"BST - Transporte"	"12.999.01.001"	1	0	1
"520059"	"BST - Transporte"	"12.999.01.003"	2	0	2
"520549"	"Georg Wagner KG"	"12.999.01.001"	3	0	3
"520549"	"Georg Wagner KG"	"12.999.01.003"	5	1	4
"522748"	"Grieshaber Logistik AG"	"12.999.01.001"	1	0	1
"523639"	"Hofmeister & Meincke GmbH & Co.KG"	"12.999.01.001"	1	0	1
"523733"	"TAXO-Obermaier  GmbH"	"12.999.01.003"	11	2	9
"523740"	"Fasieco GmbH"	"12.999.01.001"	2	0	2
"523768"	"Moehling GmbH"	"12.999.01.003"	-54	7	-61
"523768"	"Moehling GmbH"	"12.999.01.008"	60	70	-10
"523926"	"Forma Maschinenbau"	"12.999.01.001"	20	8	12
"523926"	"Forma Maschinenbau"	"12.999.01.008"	16	4	12
"523991"	"BRÜGGEN"	"12.999.01.003"	0	4	-4
"523992"	"Dennis Struß"	"12.999.01.001"	0	0	0
"524088"	"ZAL GmbH"	"12.999.01.001"	0	0	0
"524141"	"Karl Groll GmbH + Co. KG"	"12.999.01.001"	5	2	3
"524459"	"Schreibmüller"	"12.999.01.001"	0	0	0
"524459"	"Schreibmüller"	"12.999.01.003"	0	0	0
"524464"	"Schondelmaier GmbH"	"12.999.01.001"	20	0	20
"524464"	"Schondelmaier GmbH"	"12.999.01.003"	1	0	1
"524478"	"Vibracoustic Polska SP. ZO.O."	"12.999.01.001"	1	0	1
"524478"	"Vibracoustic Polska SP. ZO.O."	"12.999.01.003"	8	0	8
"524612"	"Schuler Spezialfahrzeuge GmbH"	"12.999.01.001"	1	1	0
"524612"	"Schuler Spezialfahrzeuge GmbH"	"12.999.01.003"	1	1	0
"524775"	"Neumeister Hydraulik GmbH"	"12.999.01.001"	6	0	6
"524775"	"Neumeister Hydraulik GmbH"	"12.999.01.003"	1	0	1
"524775"	"Neumeister Hydraulik GmbH"	"12.999.01.008"	9	0	9
"525106"	"Trost Auto Service Technik"	"12.999.01.001"	0	0	0
"525106"	"Trost Auto Service Technik"	"12.999.01.003"	0	0	0
"525263"	"Johann Pefferköver GmbH & Co. KG"	"12.999.01.001"	1	12	-11
"525395"	"Toni Hotz Transporte"	"12.999.01.001"	0	0	0
"525422"	"Rasche"	"12.999.01.001"	-47	0	-47
"525611"	"Massfeller GmbH"	"12.999.01.001"	2	0	2
"525927"	"Fahrzeug- und Lackiertechnik"	"12.999.01.188"	1	1	0
"525936"	"Wolfgang Wagenblast"	"12.999.01.001"	0	0	0
"525942"	"Agrargenossenschaft Werratal e.G."	"12.999.01.003"	0	0	0
"526228"	"BC Trans GmbH & Co. KG"	"12.999.01.001"	1	0	1
"526286"	"LINDENAU Full Tank Services GMBH"	"12.999.01.001"	1	1	0
"526286"	"LINDENAU Full Tank Services GMBH"	"12.999.01.003"	1	1	0
"526372"	"Trost Auto Service Technik SE"	"12.999.01.001"	109	39	70
"526372"	"Trost Auto Service Technik SE"	"12.999.01.003"	69	12	57
"526405"	"Unipro"	"12.999.01.001"	0	0	0
"526481"	"ASEAG GmbH"	"12.999.01.001"	0	0	0
"526506"	"BHC Gummi-Metall GmbH"	"12.999.01.001"	26	120	-94
"527504"	"AI Metalltechnik GmbH & Co. KG"	"12.999.01.001"	5	13	-8
"527589"	"TITAN Spezialfahrzeugbau GmbH"	"12.999.01.001"	0	1	-1
"527589"	"TITAN Spezialfahrzeugbau GmbH"	"12.999.01.003"	0	1	-1
"527678"	"SVG Autohof Stuttgart-Wangen"	"12.999.01.001"	1	0	1
"527702"	"Wütschner Fahrzeugteile GmbH"	"12.999.01.001"	0	4	-4
"527712"	"LINDENAU Full Tank Services GMBH"	"12.999.01.001"	0	1	-1
"527712"	"LINDENAU Full Tank Services GMBH"	"12.999.01.188"	0	1	-1
"527791"	"Al Reda for Import and Export Co."	"12.999.01.003"	0	1	-1
"527818"	"WM SE"	"12.999.01.003"	1	3	-2
"527949"	"Pape"	"12.999.01.003"	0	1	-1
"528003"	"Jens Jacobs GmbH"	"12.999.01.003"	0	0	0
"528226"	"Rotor Clip"	"12.999.01.003"	-75	6	-81
"528226"	"Rotor Clip"	"12.999.01.008"	46	60	-14
"528272"	"Pagenkopf Fahrzeugtechnik"	"12.999.01.001"	11	1	10
"528272"	"Pagenkopf Fahrzeugtechnik"	"12.999.01.003"	15	1	14
"528653"	"FVG GmbH & Co. KG"	"12.999.01.001"	6	18	-12
"528653"	"FVG GmbH & Co. KG"	"12.999.01.003"	1	7	-6
"528653"	"FVG GmbH & Co. KG"	"12.999.01.162"	0	0	0
"528653"	"FVG GmbH & Co. KG"	"12.999.01.163"	0	1	-1
"528693"	"Profi-Parts"	"12.999.01.001"	0	0	0
"528940"	"F.X. MEILLER GmbH & Co. KG"	"12.999.01.001"	0	0	0
"528940"	"F.X. MEILLER GmbH & Co. KG"	"12.999.01.003"	0	0	0
"529091"	"Peter Kröger GmbH"	"12.999.01.001"	1	1	0
"529091"	"Peter Kröger GmbH"	"12.999.01.003"	1	1	0
"529163"	"Frimatec Ing. GmbH"	"12.999.01.003"	0	4	-4
"529351"	"Bavaria Schweisstechnik"	"12.999.01.001"	112	36	76
"529351"	"Bavaria Schweisstechnik"	"12.999.01.003"	-80	0	-80
"529383"	"Gabler Transport & Handel"	"12.999.01.001"	1	0	1
"529419"	"AS AGE GmbH"	"12.999.01.003"	3	3	0
"529419"	"AS AGE GmbH"	"12.999.01.008"	30	30	0
"529452"	"Agrarvereinigung Darchau e.G."	"12.999.01.001"	1	1	0
"529513"	"DOLL"	"12.999.01.001"	1	37	-36
"529513"	"DOLL"	"12.999.01.003"	15	21	-6
"529513"	"DOLL"	"12.999.01.008"	2	2	0
"529513"	"DOLL"	"12.999.01.162"	22	14	8
"529513"	"DOLL"	"12.999.01.163"	8	5	3
"529513"	"DOLL"	"12.999.01.188"	8	3	5
"529520"	"Doll Sachsen GmbH"	"12.999.01.001"	6	6	0
"529520"	"Doll Sachsen GmbH"	"12.999.01.003"	6	5	1
"529520"	"Doll Sachsen GmbH"	"12.999.01.008"	4	2	2
"529520"	"Doll Sachsen GmbH"	"12.999.01.162"	14	14	0
"529520"	"Doll Sachsen GmbH"	"12.999.01.163"	4	4	0
"529520"	"Doll Sachsen GmbH"	"12.999.01.188"	2	1	1
"529666"	"Wilhelm Severt Maschinenbau GmbH"	"12.999.01.001"	0	0	0
"529666"	"Wilhelm Severt Maschinenbau GmbH"	"12.999.01.003"	0	0	0
"529734"	"Max Streicher GmbH & Co."	"12.999.01.001"	0	0	0
"529741"	"Firestone Industrial Products"	"12.999.01.001"	67	180	-113
"529864"	"WEISSENBURG Industrie-Technik"	"12.999.01.003"	4	1	3
"529894"	"Freidrich Kraft GmbH"	"12.999.01.001"	0	0	0
"529894"	"Freidrich Kraft GmbH"	"12.999.01.003"	0	0	0
"529947"	"Haas Fahrzeugtechnik GmbH"	"12.999.01.003"	0	0	0
"529985"	"Luhn & Pulvermacher"	"12.999.01.001"	17	0	17
"529986"	"LEISE GMBH & CO. KG"	"12.999.01.001"	0	0	0
"530076"	"Dreher und Schulz GbR"	"12.999.01.001"	0	0	0
"530183"	"Hermann Fliess & Co. GmbH"	"12.999.01.003"	-35	20	-55
"530310"	"Josef König-Krölleke"	"12.999.01.001"	0	0	0
"530332"	"ITL Fahrzeugbau GmbH"	"12.999.01.001"	2	2	0
"530332"	"ITL Fahrzeugbau GmbH"	"12.999.01.003"	1	1	0
"530333"	"Monroe Czechia S.R.O."	"12.999.01.001"	131	180	-49
"530338"	"BWO"	"12.999.01.001"	49	66	-17
"530338"	"BWO"	"12.999.01.003"	-14	9	-23
"530338"	"BWO"	"12.999.01.008"	0	10	-10
"530536"	"MAT Commercial Vehicle"	"12.999.01.001"	-10	0	-10
"530536"	"MAT Commercial Vehicle"	"12.999.01.003"	12	1	11
"530536"	"MAT Commercial Vehicle"	"12.999.01.008"	48	2	46
"530652"	"Waeles Nederland BV"	"12.999.01.001"	-44	0	-44
"530720"	"Bernd Glücks"	"12.999.01.001"	0	0	0
"530761"	"Matthias Kühl"	"12.999.01.001"	0	0	0
"530761"	"Matthias Kühl"	"12.999.01.003"	0	0	0
"530901"	"Kammerer-Reifen GmbH"	"12.999.01.001"	1	0	1
"530901"	"Kammerer-Reifen GmbH"	"12.999.01.003"	1	0	1
"530946"	"AL-KO Record S.A."	"12.999.01.001"	42	0	42
"530959"	"Hofgut Elbaue"	"12.999.01.001"	0	0	0
"530959"	"Hofgut Elbaue"	"12.999.01.003"	0	0	0
"530959"	"Hofgut Elbaue"	"12.999.01.008"	0	0	0
"530964"	"Peter's Transporte u. Montagen GmbH"	"12.999.01.001"	0	0	0
"530964"	"Peter's Transporte u. Montagen GmbH"	"12.999.01.003"	0	0	0
"530972"	"Karl Strack"	"12.999.01.001"	1	1	0
"530984"	"Weigelt"	"12.999.01.001"	0	1	-1
"530984"	"Weigelt"	"12.999.01.003"	0	1	-1
"531030"	"Bandis & Knopp GmbH & Co. KG"	"12.999.01.003"	0	56	-56
"531239"	"HKM Fahrzeugbau GmbH i. I."	"12.999.01.001"	1	1	0
"531239"	"HKM Fahrzeugbau GmbH i. I."	"12.999.01.003"	2	2	0
"531239"	"HKM Fahrzeugbau GmbH i. I."	"12.999.01.162"	0	0	0
"531239"	"HKM Fahrzeugbau GmbH i. I."	"12.999.01.163"	0	0	0
"531239"	"HKM Fahrzeugbau GmbH i. I."	"12.999.01.188"	1	1	0
"531247"	"WIHAG Fahrzeugsysteme GmbH"	"12.999.01.003"	4	2	2
"531252"	"Fortuna Fahrzeugbau GmbH & Co. KG"	"12.999.01.003"	4	0	4
"531285"	"A.-W. HEIL & SOHN GMBH & CO.KG"	"12.999.01.001"	0	38	-38
"531285"	"A.-W. HEIL & SOHN GMBH & CO.KG"	"12.999.01.003"	0	11	-11
"531366"	"4JET Technologies GmbH"	"12.999.01.001"	0	2	-2
"90000116"	"MANNSTAEDT GMBH"	"12.999.01.003"	0	1	-1
"90000187"	"FRAMUER-HALBACH GMBH"	"12.999.01.001"	-1	0	-1
"90000193"	"Trelleborg Sealing Solutions"	"12.999.01.003"	-1	0	-1
"90000267"	"Subtil GmbH"	"12.999.01.003"	-19	0	-19
"90000321"	"ZF Friedrichshafen AG"	"12.999.01.001"	1	0	1
"90000337"	"Leist Oberflächentechnik e.K."	"12.999.01.003"	1	0	1
"90000337"	"Leist Oberflächentechnik e.K."	"12.999.01.008"	3	0	3
"90000356"	"KARL GROLL GMBH & CO. KG"	"12.999.01.001"	1	3	-2
"90000388"	"DOLEZYCH GMBH & CO. KG"	"12.999.01.001"	-2	0	-2
"90000389"	"Schaublin S.A."	"12.999.01.003"	0	2	-2
"90000536"	"MAT Commercial Vehicle"	"12.999.01.003"	1	1	0
"90000549"	"INTRA Logistik- und"	"12.999.01.003"	0	1	-1
